"","codice_comune","comune","et_a","totale_maschi","totale_femmine","totale"
"1",28001,"Abano Terme",999,9721,10629,20350
"2",98001,"Abbadia Cerreto",999,134,140,274
"3",97001,"Abbadia Lariana",999,1556,1636,3192
"4",52001,"Abbadia San Salvatore",999,3052,3087,6139
"5",95001,"Abbasanta",999,1265,1297,2562
"6",68001,"Abbateggio",999,185,172,357
"7",15002,"Abbiategrasso",999,15923,16706,32629
"8",47023,"Abetone Cutigliano",999,883,934,1817
"9",76001,"Abriola",999,615,651,1266
"10",88001,"Acate",999,5706,4752,10458
"11",71001,"Accadia",999,1079,1114,2193
"12",4001,"Acceglio",999,77,82,159
"13",77001,"Accettura",999,788,805,1593
"14",66001,"Acciano",999,140,116,256
"15",57001,"Accumoli",999,277,239,516
"16",76002,"Acerenza",999,1039,1032,2071
"17",65001,"Acerno",999,1269,1247,2516
"18",63001,"Acerra",999,28781,29663,58444
"19",87001,"Aci Bonaccorsi",999,1707,1852,3559
"20",87002,"Aci Castello",999,8519,9263,17782
"21",87003,"Aci Catena",999,13658,14104,27762
"22",87004,"Acireale",999,24632,25958,50590
"23",87005,"Aci Sant'Antonio",999,8984,9111,18095
"24",60001,"Acquafondata",999,137,121,258
"25",78001,"Acquaformosa",999,504,468,972
"26",17001,"Acquafredda",999,765,780,1545
"27",41001,"Acqualagna",999,2070,2097,4167
"28",19001,"Acquanegra Cremonese",999,556,585,1141
"29",20001,"Acquanegra sul Chiese",999,1336,1355,2691
"30",56001,"Acquapendente",999,2655,2653,5308
"31",78002,"Acquappesa",999,862,882,1744
"32",102001,"Acquaro",999,877,949,1826
"33",44001,"Acquasanta Terme",999,1233,1209,2442
"34",55001,"Acquasparta",999,2127,2256,4383
"35",70001,"Acquaviva Collecroce",999,282,274,556
"36",72001,"Acquaviva delle Fonti",999,9608,10229,19837
"37",94001,"Acquaviva d'Isernia",999,182,169,351
"38",44002,"Acquaviva Picena",999,1788,1856,3644
"39",85001,"Acquaviva Platani",999,412,443,855
"40",83107,"Acquedolci",999,2656,2841,5497
"41",6001,"Acqui Terme",999,8909,10046,18955
"42",78003,"Acri",999,8992,9582,18574
"43",60002,"Acuto",999,900,920,1820
"44",72002,"Adelfia",999,8069,8420,16489
"45",87006,"Adrano",999,16326,17394,33720
"46",16001,"Adrara San Martino",999,1151,1012,2163
"47",16002,"Adrara San Rocco",999,419,390,809
"48",29001,"Adria",999,9047,9534,18581
"49",17002,"Adro",999,3583,3568,7151
"50",23001,"Affi",999,1211,1242,2453
"51",58001,"Affile",999,702,708,1410
"52",63002,"Afragola",999,30443,31143,61586
"53",80001,"Africo",999,1372,1338,2710
"54",33001,"Agazzano",999,984,1025,2009
"55",63003,"Agerola",999,3819,3923,7742
"56",90001,"Aggius",999,675,740,1415
"57",86001,"Agira",999,3750,3843,7593
"58",47002,"Agliana",999,8851,9109,17960
"59",5001,"Agliano Terme",999,789,748,1537
"60",1001,"Agliè",999,1248,1355,2603
"61",90062,"Aglientu",999,592,591,1183
"62",28002,"Agna",999,1545,1591,3136
"63",19002,"Agnadello",999,1964,1925,3889
"64",80002,"Agnana Calabra",999,236,219,455
"65",94002,"Agnone",999,2372,2279,4651
"66",17003,"Agnosine",999,839,797,1636
"67",25001,"Agordo",999,1934,2118,4052
"68",58002,"Agosta",999,830,850,1680
"69",12001,"Agra",999,198,202,400
"70",108001,"Agrate Brianza",999,7736,7958,15694
"71",3001,"Agrate Conturbia",999,800,752,1552
"72",84001,"Agrigento",999,27124,28193,55317
"73",65002,"Agropoli",999,10504,10845,21349
"74",42001,"Agugliano",999,2320,2329,4649
"75",24001,"Agugliaro",999,699,705,1404
"76",108002,"Aicurzio",999,1017,1046,2063
"77",95002,"Aidomaggiore",999,185,201,386
"78",86002,"Aidone",999,2090,2095,4185
"79",66002,"Aielli",999,685,687,1372
"80",78004,"Aiello Calabro",999,690,685,1375
"81",30001,"Aiello del Friuli",999,1025,1104,2129
"82",64001,"Aiello del Sabato",999,1991,1995,3986
"83",78005,"Aieta",999,362,378,740
"84",61001,"Ailano",999,516,626,1142
"85",96001,"Ailoche",999,143,157,300
"86",1002,"Airasca",999,1877,1809,3686
"87",62001,"Airola",999,3995,4081,8076
"88",8001,"Airole",999,200,170,370
"89",97002,"Airuno",999,1534,1398,2932
"90",4002,"Aisone",999,108,105,213
"91",22001,"Ala",999,4420,4374,8794
"92",90002,"Alà dei Sardi",999,893,881,1774
"93",1003,"Ala di Stura",999,244,229,473
"94",18001,"Alagna",999,388,413,801
"95",2002,"Alagna Valsesia",999,359,335,694
"96",68002,"Alanno",999,1619,1709,3328
"97",25002,"Alano di Piave",999,1381,1356,2737
"98",9001,"Alassio",999,4677,5387,10064
"99",60003,"Alatri",999,13523,14116,27639
"100",4003,"Alba",999,14859,16295,31154
"101",67001,"Alba Adriatica",999,6284,6775,13059
"102",95003,"Albagiara",999,114,115,229
"103",15005,"Albairate",999,2327,2385,4712
"104",65003,"Albanella",999,3151,3132,6283
"105",76003,"Albano di Lucania",999,667,642,1309
"106",58003,"Albano Laziale",999,19131,20622,39753
"107",16003,"Albano Sant'Alessandro",999,4156,4087,8243
"108",2003,"Albano Vercellese",999,150,159,309
"109",18002,"Albaredo Arnaboldi",999,134,102,236
"110",23002,"Albaredo d'Adige",999,2646,2622,5268
"111",14001,"Albaredo per San Marco",999,155,143,298
"112",34001,"Albareto",999,1026,1053,2079
"113",4004,"Albaretto della Torre",999,110,105,215
"114",13003,"Albavilla",999,3155,3259,6414
"115",9002,"Albenga",999,11505,12033,23538
"116",6002,"Albera Ligure",999,167,130,297
"117",72003,"Alberobello",999,4935,5239,10174
"118",71002,"Alberona",999,426,427,853
"119",13004,"Albese con Cassano",999,2050,2187,4237
"120",24002,"Albettone",999,1006,988,1994
"121",79002,"Albi",999,399,380,779
"122",22002,"Albiano",999,785,738,1523
"123",1004,"Albiano d'Ivrea",999,781,838,1619
"124",108003,"Albiate",999,3261,3457,6718
"125",78006,"Albidona",999,549,563,1112
"126",28003,"Albignasego",999,13169,13975,27144
"127",35001,"Albinea",999,4310,4582,8892
"128",16004,"Albino",999,8635,8888,17523
"129",13005,"Albiolo",999,1406,1361,2767
"130",9004,"Albisola Superiore",999,4510,5106,9616
"131",9003,"Albissola Marina",999,2457,2688,5145
"132",12002,"Albizzate",999,2510,2625,5135
"133",18003,"Albonese",999,263,276,539
"134",14002,"Albosaggia",999,1503,1498,3001
"135",5002,"Albugnano",999,244,262,506
"136",18004,"Albuzzano",999,1800,1828,3628
"137",81001,"Alcamo",999,22146,22537,44683
"138",83001,"Alcara li Fusi",999,782,873,1655
"139",22003,"Aldeno",999,1620,1654,3274
"140",21001,"Aldino/Aldein",999,827,789,1616
"141",95004,"Ales",999,630,620,1250
"142",6003,"Alessandria",999,44806,47130,91936
"143",78007,"Alessandria del Carretto",999,196,156,352
"144",84002,"Alessandria della Rocca",999,1159,1223,2382
"145",75002,"Alessano",999,2933,3114,6047
"146",75003,"Alezio",999,2707,2961,5668
"147",65004,"Alfano",999,439,492,931
"148",66003,"Alfedena",999,545,381,926
"149",17004,"Alfianello",999,1136,1151,2287
"150",6004,"Alfiano Natta",999,340,345,685
"151",39001,"Alfonsine",999,5706,5894,11600
"152",90003,"Alghero",999,20369,21896,42265
"153",16248,"Algua",999,353,329,682
"154",83002,"Alì",999,311,319,630
"155",82001,"Alia",999,1572,1670,3242
"156",77002,"Aliano",999,426,436,862
"157",6005,"Alice Bel Colle",999,361,307,668
"158",2004,"Alice Castello",999,1269,1242,2511
"159",61002,"Alife",999,3648,3712,7360
"160",82002,"Alimena",999,860,929,1789
"161",82003,"Aliminusa",999,515,506,1021
"162",83003,"Alì Terme",999,1126,1189,2315
"163",95005,"Allai",999,176,173,349
"164",25003,"Alleghe",999,534,559,1093
"165",7001,"Allein",999,107,101,208
"166",55002,"Allerona",999,828,859,1687
"167",75004,"Alliste",999,3084,3315,6399
"168",58004,"Allumiere",999,1859,1886,3745
"169",6192,"Alluvioni Piovera",999,799,818,1617
"170",16005,"Almè",999,2671,2835,5506
"171",16006,"Almenno San Bartolomeo",999,3291,3266,6557
"172",16007,"Almenno San Salvatore",999,2684,2812,5496
"173",1006,"Almese",999,3090,3233,6323
"174",24003,"Alonte",999,796,772,1568
"175",25072,"Alpago",999,3341,3286,6627
"176",1007,"Alpette",999,134,113,247
"177",1008,"Alpignano",999,8235,8374,16609
"178",33002,"Alseno",999,2349,2377,4726
"179",13006,"Alserio",999,693,680,1373
"180",72004,"Altamura",999,34413,35695,70108
"181",9005,"Altare",999,981,950,1931
"182",22235,"Altavalle",999,812,820,1632
"183",13253,"Alta Valle Intelvi",999,1580,1576,3156
"184",33049,"Alta Val Tidone",999,1494,1440,2934
"185",64002,"Altavilla Irpina",999,1914,1961,3875
"186",82004,"Altavilla Milicia",999,4407,4411,8818
"187",6007,"Altavilla Monferrato",999,206,188,394
"188",65005,"Altavilla Silentina",999,3502,3516,7018
"189",24004,"Altavilla Vicentina",999,5888,5926,11814
"190",109001,"Altidona",999,1748,1816,3564
"191",78008,"Altilia",999,369,314,683
"192",69001,"Altino",999,1498,1539,3037
"193",24005,"Altissimo",999,1130,1038,2168
"194",26001,"Altivole",999,3506,3554,7060
"195",4005,"Alto",999,82,70,152
"196",82005,"Altofonte",999,4760,5057,9817
"197",78009,"Altomonte",999,1949,2048,3997
"198",46001,"Altopascio",999,7860,8059,15919
"199",22236,"Altopiano della Vigolana",999,2558,2558,5116
"200",37062,"Alto Reno Terme",999,3443,3610,7053
"201",2170,"Alto Sermenza",999,75,65,140
"202",55003,"Alviano",999,641,703,1344
"203",61003,"Alvignano",999,2184,2276,4460
"204",60004,"Alvito",999,1228,1255,2483
"205",16008,"Alzano Lombardo",999,6614,6845,13459
"206",6008,"Alzano Scrivia",999,188,171,359
"207",13007,"Alzate Brianza",999,2389,2436,4825
"208",65006,"Amalfi",999,2270,2374,4644
"209",109002,"Amandola",999,1596,1626,3222
"210",78010,"Amantea",999,6748,7073,13821
"211",30002,"Amaro",999,424,422,846
"212",79003,"Amaroni",999,783,843,1626
"213",60005,"Amaseno",999,2050,2037,4087
"214",79004,"Amato",999,374,413,787
"215",57002,"Amatrice",999,1167,1048,2215
"216",16009,"Ambivere",999,1211,1134,2345
"217",22237,"Amblar-Don",999,279,273,552
"218",11001,"Ameglia",999,2126,2176,4302
"219",55004,"Amelia",999,5700,5835,11535
"220",78011,"Amendolara",999,1317,1354,2671
"221",3002,"Ameno",999,421,426,847
"222",62002,"Amorosi",999,1321,1325,2646
"223",30003,"Ampezzo",999,447,447,894
"224",63004,"Anacapri",999,3336,3485,6821
"225",60006,"Anagni",999,10142,10493,20635
"226",67002,"Ancarano",999,918,937,1855
"227",42002,"Ancona",999,48549,50690,99239
"228",79005,"Andali",999,303,312,615
"229",22005,"Andalo",999,564,579,1143
"230",14003,"Andalo Valtellino",999,310,282,592
"231",1009,"Andezeno",999,1006,1005,2011
"232",9006,"Andora",999,3505,3753,7258
"233",96002,"Andorno Micca",999,1441,1549,2990
"234",75005,"Andrano",999,2171,2331,4502
"235",1010,"Andrate",999,258,209,467
"236",93001,"Andreis",999,120,125,245
"237",64003,"Andretta",999,813,853,1666
"238",110001,"Andria",999,47783,49090,96873
"239",21002,"Andriano/Andrian",999,531,514,1045
"240",90004,"Anela",999,281,280,561
"241",17005,"Anfo",999,233,209,442
"242",12003,"Angera",999,2551,2805,5356
"243",51001,"Anghiari",999,2652,2755,5407
"244",23003,"Angiari",999,1234,1269,2503
"245",17006,"Angolo Terme",999,1176,1126,2302
"246",65007,"Angri",999,16733,17399,34132
"247",1011,"Angrogna",999,428,376,804
"248",58005,"Anguillara Sabazia",999,9317,9772,19089
"249",28004,"Anguillara Veneta",999,2057,2104,4161
"250",19003,"Annicco",999,989,977,1966
"251",97003,"Annone di Brianza",999,1129,1149,2278
"252",27001,"Annone Veneto",999,1958,1857,3815
"253",80003,"Anoia",999,960,1059,2019
"254",16010,"Antegnate",999,1672,1595,3267
"255",21003,"Anterivo/Altrei",999,199,193,392
"256",7002,"Antey-Saint-André",999,284,281,565
"257",58006,"Anticoli Corrado",999,431,416,847
"258",5003,"Antignano",999,479,481,960
"259",83004,"Antillo",999,406,389,795
"260",80004,"Antonimina",999,591,579,1170
"261",57003,"Antrodoco",999,1184,1122,2306
"262",103001,"Antrona Schieranco",999,198,201,399
"263",66004,"Anversa degli Abruzzi",999,157,152,309
"264",13009,"Anzano del Parco",999,835,862,1697
"265",71003,"Anzano di Puglia",999,520,540,1060
"266",76004,"Anzi",999,723,779,1502
"267",58007,"Anzio",999,29883,29472,59355
"268",37001,"Anzola dell'Emilia",999,6067,6296,12363
"269",103002,"Anzola d'Ossola",999,193,183,376
"270",7003,"Aosta",999,15630,17546,33176
"271",41002,"Apecchio",999,837,858,1695
"272",62003,"Apice",999,2610,2638,5248
"273",43002,"Apiro",999,998,1042,2040
"274",62004,"Apollosa",999,1225,1248,2473
"275",13010,"Appiano Gentile",999,3770,3953,7723
"276",21004,"Appiano sulla strada del vino/Eppan an der Weinstraße",999,7398,7574,14972
"277",43003,"Appignano",999,1968,2099,4067
"278",44005,"Appignano del Tronto",999,793,840,1633
"279",14004,"Aprica",999,729,738,1467
"280",8002,"Apricale",999,311,301,612
"281",71004,"Apricena",999,6217,6298,12515
"282",78012,"Aprigliano",999,1151,1183,2334
"283",59001,"Aprilia",999,37016,37556,74572
"284",65008,"Aquara",999,639,660,1299
"285",8003,"Aquila d'Arroscia",999,73,65,138
"286",30004,"Aquileia",999,1541,1609,3150
"287",64004,"Aquilonia",999,756,687,1443
"288",60007,"Aquino",999,2408,2500,4908
"289",75006,"Aradeo",999,4239,4594,8833
"290",84003,"Aragona",999,4243,4482,8725
"291",5004,"Aramengo",999,294,274,568
"292",93002,"Arba",999,666,624,1290
"293",95006,"Arborea",999,1856,1867,3723
"294",2006,"Arborio",999,448,393,841
"295",111001,"Arbus",999,2795,2855,5650
"296",26002,"Arcade",999,2266,2230,4496
"297",60008,"Arce",999,2667,2720,5387
"298",16011,"Arcene",999,2516,2438,4954
"299",42003,"Arcevia",999,2114,2106,4220
"300",69002,"Archi",999,934,1008,1942
"301",53001,"Arcidosso",999,2145,2110,4255
"302",58008,"Arcinazzo Romano",999,616,602,1218
"303",12004,"Arcisate",999,4799,5048,9847
"304",22006,"Arco",999,8738,9025,17763
"305",11002,"Arcola",999,4995,5210,10205
"306",23004,"Arcole",999,3210,3212,6422
"307",15007,"Arconate",999,3336,3488,6824
"308",108004,"Arcore",999,8671,9188,17859
"309",24006,"Arcugnano",999,3844,3808,7652
"310",90005,"Ardara",999,362,354,716
"311",95007,"Ardauli",999,359,401,760
"312",58117,"Ardea",999,25479,24637,50116
"313",14005,"Ardenno",999,1645,1583,3228
"314",16012,"Ardesio",999,1673,1632,3305
"315",80005,"Ardore",999,2379,2466,4845
"316",102002,"Arena",999,613,622,1235
"317",18005,"Arena Po",999,760,747,1507
"318",10001,"Arenzano",999,5303,5841,11144
"319",15009,"Arese",999,9402,10160,19562
"320",51002,"Arezzo",999,46667,49759,96426
"321",13011,"Argegno",999,334,342,676
"322",37002,"Argelato",999,4727,4926,9653
"323",38001,"Argenta",999,10353,10735,21088
"324",4006,"Argentera",999,40,40,80
"325",4007,"Arguello",999,99,96,195
"326",79007,"Argusto",999,206,218,424
"327",69003,"Ari",999,541,521,1062
"328",64005,"Ariano Irpino",999,10189,10701,20890
"329",29002,"Ariano nel Polesine",999,1860,2000,3860
"330",58009,"Ariccia",999,8684,9313,17997
"331",69004,"Arielli",999,514,539,1053
"332",61004,"Arienzo",999,2662,2717,5379
"333",1012,"Arignano",999,564,511,1075
"334",91001,"Aritzo",999,662,559,1221
"335",103003,"Arizzano",999,949,1026,1975
"336",56002,"Arlena di Castro",999,419,401,820
"337",15010,"Arluno",999,6157,6295,12452
"338",3006,"Armeno",999,995,1093,2088
"339",76005,"Armento",999,269,281,550
"340",8004,"Armo",999,59,61,120
"341",111002,"Armungia",999,210,190,400
"342",7004,"Arnad",999,591,643,1234
"343",60009,"Arnara",999,1064,1138,2202
"344",9007,"Arnasco",999,280,273,553
"345",75007,"Arnesano",999,1973,1952,3925
"346",103004,"Arola",999,121,122,243
"347",3008,"Arona",999,6400,7357,13757
"348",13012,"Arosio",999,2502,2630,5132
"349",62005,"Arpaia",999,998,987,1985
"350",62006,"Arpaise",999,366,365,731
"351",60010,"Arpino",999,3221,3398,6619
"352",28005,"Arquà Petrarca",999,895,899,1794
"353",29003,"Arquà Polesine",999,1300,1270,2570
"354",44006,"Arquata del Tronto",999,482,458,940
"355",6009,"Arquata Scrivia",999,3043,3240,6283
"356",28006,"Arre",999,1046,1017,2063
"357",55005,"Arrone",999,1206,1315,2521
"358",12005,"Arsago Seprio",999,2352,2380,4732
"359",25004,"Arsiè",999,1074,1094,2168
"360",24007,"Arsiero",999,1560,1481,3041
"361",67003,"Arsita",999,368,365,733
"362",58010,"Arsoli",999,642,725,1367
"363",30005,"Arta Terme",999,1027,1009,2036
"364",30006,"Artegna",999,1391,1489,2880
"365",58011,"Artena",999,6730,6908,13638
"366",17007,"Artogne",999,1808,1817,3625
"367",7005,"Arvier",999,398,408,806
"368",90006,"Arzachena",999,6770,6637,13407
"369",16013,"Arzago d'Adda",999,1358,1371,2729
"370",91002,"Arzana",999,1123,1097,2220
"371",63005,"Arzano",999,15538,16353,31891
"372",28007,"Arzergrande",999,2381,2434,4815
"373",24008,"Arzignano",999,13018,12585,25603
"374",65009,"Ascea",999,2903,2925,5828
"375",52002,"Asciano",999,3337,3477,6814
"376",44007,"Ascoli Piceno",999,22014,23469,45483
"377",71005,"Ascoli Satriano",999,2967,2838,5805
"378",57004,"Ascrea",999,112,93,205
"379",24009,"Asiago",999,3026,3222,6248
"380",24010,"Asigliano Veneto",999,423,419,842
"381",2007,"Asigliano Vercellese",999,673,692,1365
"382",20002,"Asola",999,4855,5025,9880
"383",26003,"Asolo",999,4513,4472,8985
"384",15011,"Assago",999,4570,4668,9238
"385",92003,"Assemini",999,12570,13187,25757
"386",54001,"Assisi",999,13287,14262,27549
"387",13013,"Asso",999,1713,1783,3496
"388",95008,"Assolo",999,173,155,328
"389",86003,"Assoro",999,2361,2411,4772
"390",5005,"Asti",999,35508,38279,73787
"391",95009,"Asuni",999,146,153,299
"392",66005,"Ateleta",999,556,545,1101
"393",76006,"Atella",999,1823,1808,3631
"394",65010,"Atena Lucana",999,1178,1182,2360
"395",69005,"Atessa",999,5065,5271,10336
"396",60011,"Atina",999,1979,2146,4125
"397",65011,"Atrani",999,376,416,792
"398",67004,"Atri",999,4922,5019,9941
"399",64006,"Atripalda",999,4949,5382,10331
"400",55006,"Attigliano",999,990,998,1988
"401",30007,"Attimis",999,794,848,1642
"402",91003,"Atzara",999,505,471,976
"403",89001,"Augusta",999,17184,17434,34618
"404",65012,"Auletta",999,1085,1062,2147
"405",45001,"Aulla",999,5208,5447,10655
"406",103005,"Aurano",999,56,46,102
"407",8005,"Aurigo",999,170,157,327
"408",25005,"Auronzo di Cadore",999,1477,1562,3039
"409",60012,"Ausonia",999,1187,1208,2395
"410",91004,"Austis",999,379,370,749
"411",10002,"Avegno",999,1277,1284,2561
"412",21005,"Avelengo/Hafling",999,408,388,796
"413",64007,"Avella",999,3640,3852,7492
"414",64008,"Avellino",999,24660,27501,52161
"415",16014,"Averara",999,99,79,178
"416",61005,"Aversa",999,23792,25734,49526
"417",73001,"Avetrana",999,2984,3215,6199
"418",66006,"Avezzano",999,19794,21087,40881
"419",93004,"Aviano",999,4498,4488,8986
"420",16015,"Aviatico",999,318,262,580
"421",1013,"Avigliana",999,5990,6238,12228
"422",76007,"Avigliano",999,5153,5395,10548
"423",55033,"Avigliano Umbro",999,1195,1158,2353
"424",22007,"Avio",999,2069,2065,4134
"425",7006,"Avise",999,144,158,302
"426",89002,"Avola",999,15060,15446,30506
"427",6010,"Avolasca",999,131,123,254
"428",7007,"Ayas",999,689,679,1368
"429",7008,"Aymavilles",999,1035,1069,2104
"430",1014,"Azeglio",999,617,627,1244
"431",19004,"Azzanello",999,305,312,617
"432",5006,"Azzano d'Asti",999,189,198,387
"433",93005,"Azzano Decimo",999,7819,7931,15750
"434",17008,"Azzano Mella",999,1814,1695,3509
"435",16016,"Azzano San Paolo",999,3726,3891,7617
"436",12006,"Azzate",999,2233,2384,4617
"437",12007,"Azzio",999,395,375,770
"438",16017,"Azzone",999,185,172,357
"439",103006,"Baceno",999,419,453,872
"440",63006,"Bacoli",999,12290,12863,25153
"441",8006,"Badalucco",999,530,548,1078
"442",90081,"Badesi",999,904,934,1838
"443",21006,"Badia/Abtei",999,1742,1787,3529
"444",23005,"Badia Calavena",999,1337,1307,2644
"445",18006,"Badia Pavese",999,215,191,406
"446",29004,"Badia Polesine",999,5041,5168,10209
"447",51003,"Badia Tedalda",999,486,464,950
"448",79008,"Badolato",999,1351,1482,2833
"449",80006,"Bagaladi",999,433,499,932
"450",82006,"Bagheria",999,25902,27119,53021
"451",39002,"Bagnacavallo",999,8056,8427,16483
"452",80007,"Bagnara Calabra",999,4578,4620,9198
"453",39003,"Bagnara di Romagna",999,1198,1198,2396
"454",18007,"Bagnaria",999,297,329,626
"455",30008,"Bagnaria Arsa",999,1692,1764,3456
"456",4008,"Bagnasco",999,469,492,961
"457",16018,"Bagnatica",999,2280,2224,4504
"458",46002,"Bagni di Lucca",999,2794,2822,5616
"459",48001,"Bagno a Ripoli",999,11903,13168,25071
"460",40001,"Bagno di Romagna",999,2734,2839,5573
"461",94003,"Bagnoli del Trigno",999,315,306,621
"462",28008,"Bagnoli di Sopra",999,1687,1682,3369
"463",64009,"Bagnoli Irpino",999,1524,1495,3019
"464",19005,"Bagnolo Cremasco",999,2517,2482,4999
"465",75008,"Bagnolo del Salento",999,864,888,1752
"466",29005,"Bagnolo di Po",999,621,596,1217
"467",35002,"Bagnolo in Piano",999,4708,4881,9589
"468",17009,"Bagnolo Mella",999,6200,6232,12432
"469",4009,"Bagnolo Piemonte",999,2900,2937,5837
"470",20003,"Bagnolo San Vito",999,2958,2952,5910
"471",45002,"Bagnone",999,816,856,1672
"472",56003,"Bagnoregio",999,1627,1709,3336
"473",17010,"Bagolino",999,1892,1890,3782
"474",61006,"Baia e Latina",999,993,1011,2004
"475",64010,"Baiano",999,2121,2277,4398
"476",1015,"Bairo",999,369,416,785
"477",35003,"Baiso",999,1664,1553,3217
"478",8007,"Bajardo",999,210,154,364
"479",1016,"Balangero",999,1465,1597,3062
"480",5007,"Baldichieri d'Asti",999,551,574,1125
"481",1017,"Baldissero Canavese",999,245,262,507
"482",4010,"Baldissero d'Alba",999,540,524,1064
"483",1018,"Baldissero Torinese",999,1855,1897,3752
"484",82007,"Balestrate",999,2987,3270,6257
"485",9008,"Balestrino",999,261,267,528
"486",97004,"Ballabio",999,2138,2067,4205
"487",111003,"Ballao",999,365,353,718
"488",1019,"Balme",999,53,47,100
"489",2008,"Balmuccia",999,56,59,115
"490",2009,"Balocco",999,121,93,214
"491",66007,"Balsorano",999,1621,1630,3251
"492",76008,"Balvano",999,877,813,1690
"493",6011,"Balzola",999,607,614,1221
"494",90007,"Banari",999,260,255,515
"495",1020,"Banchette",999,1483,1628,3111
"496",103007,"Bannio Anzino",999,230,212,442
"497",76009,"Banzi",999,594,572,1166
"498",28009,"Baone",999,1549,1528,3077
"499",95010,"Baradili",999,40,40,80
"500",76010,"Baragiano",999,1243,1237,2480
"501",70002,"Baranello",999,1230,1230,2460
"502",63007,"Barano d'Ischia",999,4981,5018,9999
"503",15250,"Baranzate",999,6157,5692,11849
"504",12008,"Barasso",999,811,861,1672
"505",95011,"Baratili San Pietro",999,586,617,1203
"506",1021,"Barbania",999,780,781,1561
"507",42004,"Barbara",999,629,634,1263
"508",24124,"Barbarano Mossano",999,3091,3110,6201
"509",56004,"Barbarano Romano",999,507,497,1004
"510",4011,"Barbaresco",999,299,307,606
"511",17011,"Barbariga",999,1175,1146,2321
"512",16019,"Barbata",999,345,350,695
"513",48002,"Barberino di Mugello",999,5472,5499,10971
"514",48054,"Barberino Tavarnelle",999,5971,5965,11936
"515",18008,"Barbianello",999,436,438,874
"516",21007,"Barbiano/Barbian",999,861,878,1739
"517",28010,"Barbona",999,297,279,576
"518",83005,"Barcellona Pozzo di Gotto",999,19488,20390,39878
"519",93006,"Barcis",999,113,114,227
"520",7009,"Bard",999,43,59,102
"521",12144,"Bardello con Malgesso e Bregano",999,1788,1846,3634
"522",34002,"Bardi",999,1001,981,1982
"523",9009,"Bardineto",999,369,392,761
"524",23006,"Bardolino",999,3369,3562,6931
"525",1022,"Bardonecchia",999,1487,1493,2980
"526",15012,"Bareggio",999,8422,8755,17177
"527",3012,"Barengo",999,350,367,717
"528",95012,"Baressa",999,275,278,553
"529",66008,"Barete",999,326,303,629
"530",46003,"Barga",999,4625,4762,9387
"531",10003,"Bargagli",999,1290,1239,2529
"532",4012,"Barge",999,3727,3691,7418
"533",17012,"Barghe",999,605,537,1142
"534",72006,"Bari",999,152107,164105,316212
"535",16020,"Bariano",999,2177,2060,4237
"536",37003,"Baricella",999,3531,3607,7138
"537",76011,"Barile",999,1266,1296,2562
"538",91005,"Bari Sardo",999,1831,1967,3798
"539",66009,"Barisciano",999,815,845,1660
"540",108005,"Barlassina",999,3410,3497,6907
"541",110002,"Barletta",999,45787,46632,92419
"542",13015,"Barni",999,297,291,588
"543",4013,"Barolo",999,294,320,614
"544",1023,"Barone Canavese",999,271,285,556
"545",65013,"Baronissi",999,8286,8601,16887
"546",86004,"Barrafranca",999,5481,6136,11617
"547",111004,"Barrali",999,570,529,1099
"548",66010,"Barrea",999,357,347,704
"549",111005,"Barumini",999,576,560,1136
"550",97005,"Barzago",999,1168,1195,2363
"551",16021,"Barzana",999,1047,973,2020
"552",97006,"Barzanò",999,2461,2574,5035
"553",97007,"Barzio",999,614,653,1267
"554",6012,"Basaluzzo",999,1021,1010,2031
"555",18009,"Bascapè",999,953,853,1806
"556",55007,"Baschi",999,1264,1290,2554
"557",67005,"Basciano",999,1175,1144,2319
"558",22009,"Baselga di Pinè",999,2621,2588,5209
"559",62007,"Baselice",999,968,1096,2064
"560",15014,"Basiano",999,1865,1815,3680
"561",83006,"Basicò",999,312,322,634
"562",15015,"Basiglio",999,3847,4097,7944
"563",30009,"Basiliano",999,2550,2600,5150
"564",17013,"Bassano Bresciano",999,1190,1137,2327
"565",24012,"Bassano del Grappa",999,20298,22136,42434
"566",56006,"Bassano in Teverina",999,642,641,1283
"567",56005,"Bassano Romano",999,2318,2323,4641
"568",59002,"Bassiano",999,730,700,1430
"569",6013,"Bassignana",999,775,788,1563
"570",4014,"Bastia Mondovì",999,312,312,624
"571",54002,"Bastia Umbra",999,10302,11009,21311
"572",18011,"Bastida Pancarana",999,486,460,946
"573",36001,"Bastiglia",999,2121,2094,4215
"574",28011,"Battaglia Terme",999,1851,1935,3786
"575",4015,"Battifollo",999,157,90,247
"576",65014,"Battipaglia",999,24516,25119,49635
"577",18012,"Battuda",999,349,318,667
"578",82008,"Baucina",999,927,922,1849
"579",95013,"Bauladu",999,298,315,613
"580",91006,"Baunei",999,1680,1721,3401
"581",103008,"Baveno",999,2266,2363,4629
"582",12010,"Bedero Valcuvia",999,336,324,660
"583",17014,"Bedizzole",999,6078,6166,12244
"584",22011,"Bedollo",999,755,736,1491
"585",34003,"Bedonia",999,1525,1591,3116
"586",16022,"Bedulita",999,353,366,719
"587",103009,"Bee",999,368,405,773
"588",1024,"Beinasco",999,8429,9033,17462
"589",4016,"Beinette",999,1765,1738,3503
"590",79009,"Belcastro",999,635,596,1231
"591",23007,"Belfiore",999,1751,1615,3366
"592",41005,"Belforte all'Isauro",999,374,371,745
"593",43004,"Belforte del Chienti",999,905,946,1851
"594",6014,"Belforte Monferrato",999,258,241,499
"595",18013,"Belgioioso",999,3137,3270,6407
"596",103010,"Belgirate",999,224,255,479
"597",76012,"Bella",999,2338,2319,4657
"598",13250,"Bellagio",999,1727,1859,3586
"599",97008,"Bellano",999,1683,1738,3421
"600",67006,"Bellante",999,3352,3464,6816
"601",99001,"Bellaria-Igea Marina",999,9566,9912,19478
"602",58012,"Bellegra",999,1286,1340,2626
"603",4017,"Bellino",999,51,45,96
"604",15016,"Bellinzago Lombardo",999,1891,1936,3827
"605",3016,"Bellinzago Novarese",999,4703,4730,9433
"606",65158,"Bellizzi",999,6577,6725,13302
"607",61007,"Bellona",999,2925,3080,6005
"608",65015,"Bellosguardo",999,329,352,681
"609",25006,"Belluno",999,16961,18526,35487
"610",108006,"Bellusco",999,3676,3783,7459
"611",78013,"Belmonte Calabro",999,821,872,1693
"612",60013,"Belmonte Castello",999,340,337,677
"613",94004,"Belmonte del Sannio",999,294,333,627
"614",57005,"Belmonte in Sabina",999,310,319,629
"615",82009,"Belmonte Mezzagno",999,5311,5502,10813
"616",109003,"Belmonte Piceno",999,269,287,556
"617",87007,"Belpasso",999,13998,14135,28133
"618",78014,"Belsito",999,455,437,892
"619",101001,"Belvedere di Spinello",999,942,988,1930
"620",4018,"Belvedere Langhe",999,168,179,347
"621",78015,"Belvedere Marittimo",999,4320,4747,9067
"622",42005,"Belvedere Ostrense",999,1011,1056,2067
"623",5008,"Belveglio",999,152,152,304
"624",91007,"Belvì",999,284,266,550
"625",14006,"Bema",999,58,57,115
"626",13021,"Bene Lario",999,174,167,341
"627",80008,"Benestare",999,1255,1222,2477
"628",90008,"Benetutti",999,819,845,1664
"629",4019,"Bene Vagienna",999,1851,1806,3657
"630",4020,"Benevello",999,227,226,453
"631",62008,"Benevento",999,26786,29257,56043
"632",96003,"Benna",999,560,587,1147
"633",37005,"Bentivoglio",999,2870,2913,5783
"634",16023,"Berbenno",999,1209,1246,2455
"635",14007,"Berbenno di Valtellina",999,2052,2011,4063
"636",34004,"Berceto",999,1032,933,1965
"637",90009,"Berchidda",999,1286,1295,2581
"638",13022,"Beregazzo con Figliaro",999,1377,1448,2825
"639",18014,"Bereguardo",999,1442,1436,2878
"640",6015,"Bergamasco",999,334,343,677
"641",16024,"Bergamo",999,57217,63287,120504
"642",29006,"Bergantino",999,1173,1212,2385
"643",9010,"Bergeggi",999,501,546,1047
"644",4021,"Bergolo",999,28,25,53
"645",17015,"Berlingo",999,1415,1319,2734
"646",77003,"Bernalda",999,5999,5922,11921
"647",108007,"Bernareggio",999,5822,5750,11572
"648",15019,"Bernate Ticino",999,1453,1488,2941
"649",4022,"Bernezzo",999,2117,2133,4250
"650",40003,"Bertinoro",999,5456,5650,11106
"651",30010,"Bertiolo",999,1151,1194,2345
"652",98002,"Bertonico",999,536,534,1070
"653",5009,"Berzano di San Pietro",999,239,180,419
"654",6016,"Berzano di Tortona",999,77,82,159
"655",17016,"Berzo Demo",999,762,720,1482
"656",17017,"Berzo Inferiore",999,1242,1221,2463
"657",16025,"Berzo San Fermo",999,730,673,1403
"658",108008,"Besana in Brianza",999,7642,7811,15453
"659",12011,"Besano",999,1242,1272,2514
"660",15022,"Besate",999,1017,1030,2047
"661",22013,"Besenello",999,1418,1382,2800
"662",33003,"Besenzone",999,494,456,950
"663",12012,"Besnate",999,2678,2787,5465
"664",12013,"Besozzo",999,4221,4551,8772
"665",90010,"Bessude",999,183,192,375
"666",33004,"Bettola",999,1353,1294,2647
"667",54003,"Bettona",999,2058,2193,4251
"668",103011,"Beura-Cardezza",999,714,696,1410
"669",54004,"Bevagna",999,2372,2388,4760
"670",11003,"Beverino",999,1117,1130,2247
"671",23008,"Bevilacqua",999,927,862,1789
"672",87008,"Biancavilla",999,11131,11798,22929
"673",78016,"Bianchi",999,602,570,1172
"674",80009,"Bianco",999,2091,2150,4241
"675",3018,"Biandrate",999,692,648,1340
"676",12014,"Biandronno",999,1543,1635,3178
"677",16026,"Bianzano",999,315,303,618
"678",2011,"Bianzè",999,923,947,1870
"679",14008,"Bianzone",999,645,623,1268
"680",108009,"Biassono",999,5954,6389,12343
"681",35004,"Bibbiano",999,5082,5139,10221
"682",51004,"Bibbiena",999,5984,5938,11922
"683",49001,"Bibbona",999,1622,1580,3202
"684",1025,"Bibiana",999,1697,1631,3328
"685",71006,"Biccari",999,1299,1327,2626
"686",30011,"Bicinicco",999,886,906,1792
"687",95014,"Bidonì",999,66,56,122
"688",96004,"Biella",999,20390,22563,42953
"689",17018,"Bienno",999,1864,1907,3771
"690",22015,"Bieno",999,225,240,465
"691",50001,"Bientina",999,4171,4425,8596
"692",13023,"Binago",999,2419,2428,4847
"693",15024,"Binasco",999,3362,3731,7093
"694",72008,"Binetto",999,1063,1078,2141
"695",96005,"Bioglio",999,475,437,912
"696",7010,"Bionaz",999,118,104,222
"697",17019,"Bione",999,657,641,1298
"698",91008,"Birori",999,240,250,490
"699",64011,"Bisaccia",999,1797,1739,3536
"700",82010,"Bisacquino",999,1996,2063,4059
"701",110003,"Bisceglie",999,26448,27073,53521
"702",66011,"Bisegna",999,99,114,213
"703",67007,"Bisenti",999,839,833,1672
"704",78017,"Bisignano",999,4725,4750,9475
"705",6017,"Bistagno",999,845,872,1717
"706",12015,"Bisuschio",999,2080,2196,4276
"707",72010,"Bitetto",999,5747,6001,11748
"708",72011,"Bitonto",999,26166,26923,53089
"709",72012,"Bitritto",999,5550,5787,11337
"710",91009,"Bitti",999,1220,1323,2543
"711",84004,"Bivona",999,1511,1618,3129
"712",80010,"Bivongi",999,557,609,1166
"713",13024,"Bizzarone",999,883,895,1778
"714",22017,"Bleggio Superiore",999,771,738,1509
"715",16027,"Blello",999,33,41,74
"716",56007,"Blera",999,1420,1483,2903
"717",13025,"Blessagno",999,157,147,304
"718",13026,"Blevio",999,503,554,1057
"719",82082,"Blufi",999,401,461,862
"720",28012,"Boara Pisani",999,1198,1156,2354
"721",33005,"Bobbio",999,1657,1765,3422
"722",1026,"Bobbio Pellice",999,261,275,536
"723",3019,"Boca",999,576,574,1150
"724",78018,"Bocchigliero",999,471,569,1040
"725",2014,"Boccioleto",999,78,83,161
"726",22018,"Bocenago",999,202,196,398
"727",12016,"Bodio Lomnago",999,1078,1175,2253
"728",98003,"Boffalora d'Adda",999,858,879,1737
"729",15026,"Boffalora sopra Ticino",999,2021,2058,4079
"730",10004,"Bogliasco",999,2095,2252,4347
"731",103012,"Bognanco",999,109,83,192
"732",3021,"Bogogno",999,628,679,1307
"733",9011,"Boissano",999,1283,1251,2534
"734",70003,"Bojano",999,3725,3812,7537
"735",11004,"Bolano",999,3680,3791,7471
"736",16028,"Bolgare",999,3358,3322,6680
"737",15027,"Bollate",999,17489,18831,36320
"738",1027,"Bollengo",999,1071,1047,2118
"739",37006,"Bologna",999,186464,204054,390518
"740",68003,"Bolognano",999,497,505,1002
"741",82011,"Bolognetta",999,2050,2065,4115
"742",43005,"Bolognola",999,75,66,141
"743",91010,"Bolotana",999,1073,1246,2319
"744",56008,"Bolsena",999,1793,1878,3671
"745",16029,"Boltiere",999,3200,3075,6275
"746",21008,"Bolzano/Bozen",999,51441,55123,106564
"747",3022,"Bolzano Novarese",999,584,558,1142
"748",24013,"Bolzano Vicentino",999,3259,3249,6508
"749",56009,"Bomarzo",999,861,830,1691
"750",69006,"Bomba",999,358,351,709
"751",85002,"Bompensiere",999,238,241,479
"752",82012,"Bompietro",999,544,609,1153
"753",36002,"Bomporto",999,5171,5096,10267
"754",95015,"Bonarcado",999,761,778,1539
"755",11005,"Bonassola",999,368,410,778
"756",16030,"Bonate Sopra",999,5231,5230,10461
"757",16031,"Bonate Sotto",999,3354,3329,6683
"758",23009,"Bonavigo",999,1023,893,1916
"759",38003,"Bondeno",999,6901,7024,13925
"760",22021,"Bondone",999,326,318,644
"761",62009,"Bonea",999,689,683,1372
"762",70004,"Bonefro",999,590,601,1191
"763",19006,"Bonemerse",999,718,744,1462
"764",78019,"Bonifati",999,1220,1350,2570
"765",64012,"Bonito",999,1105,1107,2212
"766",90011,"Bonnanaro",999,435,476,911
"767",90012,"Bono",999,1628,1662,3290
"768",90013,"Bonorva",999,1580,1549,3129
"769",4023,"Bonvicino",999,49,49,98
"770",57006,"Borbona",999,298,275,573
"771",25007,"Borca di Cadore",999,414,410,824
"772",30012,"Bordano",999,345,354,699
"773",8008,"Bordighera",999,4771,5432,10203
"774",19007,"Bordolano",999,298,284,582
"775",34005,"Bore",999,331,306,637
"776",35005,"Boretto",999,2630,2671,5301
"777",18015,"Borgarello",999,1316,1393,2709
"778",1028,"Borgaro Torinese",999,5675,6048,11723
"779",82013,"Borgetto",999,3512,3608,7120
"780",8009,"Borghetto d'Arroscia",999,212,191,403
"781",6018,"Borghetto di Borbera",999,971,948,1919
"782",11006,"Borghetto di Vara",999,433,446,879
"783",98004,"Borghetto Lodigiano",999,2191,2162,4353
"784",9012,"Borghetto Santo Spirito",999,2195,2423,4618
"785",40004,"Borghi",999,1469,1417,2886
"786",79011,"Borgia",999,3522,3691,7213
"787",1029,"Borgiallo",999,293,295,588
"788",9013,"Borgio Verezzi",999,1020,1082,2102
"789",46004,"Borgo a Mozzano",999,3293,3401,6694
"790",20073,"Borgocarbonara",999,931,930,1861
"791",22238,"Borgo Chiese",999,984,950,1934
"792",2015,"Borgo d'Ale",999,1089,1106,2195
"793",22252,"Borgo d'Anaunia",999,1292,1261,2553
"794",16032,"Borgo di Terzo",999,616,579,1195
"795",1030,"Borgofranco d'Ivrea",999,1666,1808,3474
"796",22239,"Borgo Lares",999,378,350,728
"797",3023,"Borgolavezzaro",999,969,1031,2000
"798",4024,"Borgomale",999,174,195,369
"799",3024,"Borgomanero",999,10223,11047,21270
"800",20072,"Borgo Mantovano",999,2560,2701,5261
"801",8010,"Borgomaro",999,427,391,818
"802",1031,"Borgomasino",999,372,393,765
"803",103078,"Borgomezzavalle",999,144,146,290
"804",1032,"Borgone Susa",999,1116,1089,2205
"805",33006,"Borgonovo Val Tidone",999,4182,4054,8236
"806",41006,"Borgo Pace",999,260,265,525
"807",18016,"Borgo Priolo",999,640,615,1255
"808",6019,"Borgoratto Alessandrino",999,257,287,544
"809",18017,"Borgoratto Mormorolo",999,194,203,397
"810",28013,"Borgoricco",999,4531,4472,9003
"811",57007,"Borgorose",999,2167,2035,4202
"812",4025,"Borgo San Dalmazzo",999,6205,6359,12564
"813",17020,"Borgo San Giacomo",999,2792,2723,5515
"814",98005,"Borgo San Giovanni",999,1253,1220,2473
"815",48004,"Borgo San Lorenzo",999,8933,9390,18323
"816",6020,"Borgo San Martino",999,690,663,1353
"817",18018,"Borgo San Siro",999,489,469,958
"818",17021,"Borgosatollo",999,4587,4526,9113
"819",2016,"Borgosesia",999,5724,6327,12051
"820",3025,"Borgo Ticino",999,2607,2579,5186
"821",37007,"Borgo Tossignano",999,1585,1600,3185
"822",25074,"Borgo Valbelluna",999,6661,6815,13476
"823",34006,"Borgo Val di Taro",999,3325,3423,6748
"824",22022,"Borgo Valsugana",999,3492,3589,7081
"825",57008,"Borgo Velino",999,443,472,915
"826",28107,"Borgo Veneto",999,3547,3503,7050
"827",2017,"Borgo Vercelli",999,1105,1129,2234
"828",20071,"Borgo Virgilio",999,7461,7566,15027
"829",9014,"Bormida",999,168,159,327
"830",14009,"Bormio",999,1927,2011,3938
"831",18019,"Bornasco",999,1350,1315,2665
"832",17022,"Borno",999,1187,1248,2435
"833",95016,"Boroneddu",999,68,89,157
"834",91011,"Borore",999,948,982,1930
"835",69007,"Borrello",999,178,177,355
"836",96006,"Borriana",999,414,446,860
"837",26004,"Borso del Grappa",999,2969,2959,5928
"838",91012,"Bortigali",999,583,631,1214
"839",90014,"Bortigiadas",999,355,354,709
"840",90015,"Borutta",999,120,122,242
"841",10005,"Borzonasca",999,918,890,1808
"842",95079,"Bosa",999,3616,3784,7400
"843",29007,"Bosaro",999,709,703,1412
"844",23010,"Boschi Sant'Anna",999,685,695,1380
"845",23011,"Bosco Chiesanuova",999,1892,1641,3533
"846",6021,"Bosco Marengo",999,1132,1073,2205
"847",1033,"Bosconero",999,1517,1558,3075
"848",63008,"Boscoreale",999,12745,13148,25893
"849",63009,"Boscotrecase",999,4835,5042,9877
"850",4026,"Bosia",999,85,85,170
"851",6022,"Bosio",999,546,496,1042
"852",97009,"Bosisio Parini",999,1647,1609,3256
"853",18020,"Bosnasco",999,328,313,641
"854",16033,"Bossico",999,489,480,969
"855",4027,"Bossolasco",999,305,347,652
"856",79012,"Botricello",999,2454,2535,4989
"857",75009,"Botrugno",999,1241,1380,2621
"858",16034,"Bottanuco",999,2584,2495,5079
"859",17023,"Botticino",999,5256,5473,10729
"860",90016,"Bottidda",999,326,328,654
"861",80011,"Bova",999,231,198,429
"862",80012,"Bovalino",999,4198,4471,8669
"863",80013,"Bova Marina",999,2014,2042,4056
"864",17024,"Bovegno",999,982,1015,1997
"865",4028,"Boves",999,4765,4891,9656
"866",17025,"Bovezzo",999,3552,3755,7307
"867",60014,"Boville Ernica",999,4131,4170,8301
"868",71007,"Bovino",999,1442,1475,2917
"869",108010,"Bovisio-Masciago",999,8247,8645,16892
"870",28014,"Bovolenta",999,1723,1708,3431
"871",23012,"Bovolone",999,8061,8103,16164
"872",6023,"Bozzole",999,201,145,346
"873",20007,"Bozzolo",999,2009,2034,4043
"874",4029,"Bra",999,14507,15295,29802
"875",16035,"Bracca",999,358,351,709
"876",58013,"Bracciano",999,8911,9605,18516
"877",65016,"Bracigliano",999,2687,2635,5322
"878",21009,"Braies/Prags",999,343,354,697
"879",18021,"Brallo di Pregola",999,253,222,475
"880",80014,"Brancaleone",999,1600,1636,3236
"881",17026,"Brandico",999,889,843,1732
"882",1034,"Brandizzo",999,4247,4444,8691
"883",16036,"Branzi",999,315,315,630
"884",17027,"Braone",999,352,338,690
"885",12017,"Brebbia",999,1553,1559,3112
"886",26005,"Breda di Piave",999,3834,3842,7676
"887",24014,"Breganze",999,4072,4308,8380
"888",13028,"Bregnano",999,3257,3195,6452
"889",16037,"Brembate",999,4346,4270,8616
"890",16038,"Brembate di Sopra",999,3986,3999,7985
"891",98006,"Brembio",999,1432,1319,2751
"892",18022,"Breme",999,356,350,706
"893",24015,"Brendola",999,3375,3369,6744
"894",13029,"Brenna",999,1126,1078,2204
"895",21010,"Brennero/Brenner",999,1232,1133,2365
"896",17028,"Breno",999,2277,2350,4627
"897",12019,"Brenta",999,854,878,1732
"898",23013,"Brentino Belluno",999,692,655,1347
"899",22025,"Brentonico",999,2071,2053,4124
"900",23014,"Brenzone sul Garda",999,1136,1299,2435
"901",35006,"Brescello",999,2807,2767,5574
"902",17029,"Brescia",999,95829,102859,198688
"903",22026,"Bresimo",999,124,120,244
"904",18023,"Bressana Bottarone",999,1706,1748,3454
"905",21011,"Bressanone/Brixen",999,11221,11783,23004
"906",24016,"Bressanvido",999,1571,1569,3140
"907",15032,"Bresso",999,12865,13383,26248
"908",12020,"Brezzo di Bedero",999,628,576,1204
"909",4030,"Briaglia",999,164,146,310
"910",102003,"Briatico",999,1922,1787,3709
"911",1035,"Bricherasio",999,2306,2309,4615
"912",13030,"Brienno",999,152,165,317
"913",76013,"Brienza",999,1961,1918,3879
"914",4031,"Briga Alta",999,26,15,41
"915",3026,"Briga Novarese",999,1345,1438,2783
"916",6024,"Brignano-Frascata",999,212,198,410
"917",16040,"Brignano Gera d'Adda",999,3058,3096,6154
"918",74001,"Brindisi",999,39565,42703,82268
"919",76014,"Brindisi Montagna",999,407,369,776
"920",12021,"Brinzio",999,410,362,772
"921",3027,"Briona",999,533,601,1134
"922",17030,"Brione",999,399,350,749
"923",108011,"Briosco",999,3025,3100,6125
"924",39004,"Brisighella",999,3621,3552,7173
"925",12022,"Brissago-Valtravaglia",999,644,668,1312
"926",7011,"Brissogne",999,492,460,952
"927",68004,"Brittoli",999,124,125,249
"928",97010,"Brivio",999,2257,2186,4443
"929",60015,"Broccostella",999,1284,1354,2638
"930",24017,"Brogliano",999,2027,2015,4042
"931",102004,"Brognaturo",999,404,300,704
"932",83007,"Brolo",999,2723,3016,5739
"933",4032,"Brondello",999,144,120,264
"934",18024,"Broni",999,4711,5073,9784
"935",87009,"Bronte",999,8771,9427,18198
"936",21012,"Bronzolo/Branzoll",999,1378,1375,2753
"937",4033,"Brossasco",999,497,494,991
"938",1036,"Brosso",999,189,201,390
"939",103013,"Brovello-Carpugnino",999,397,394,791
"940",1037,"Brozolo",999,228,218,446
"941",108012,"Brugherio",999,17159,18153,35312
"942",28015,"Brugine",999,3503,3602,7105
"943",11007,"Brugnato",999,622,654,1276
"944",93007,"Brugnera",999,4635,4636,9271
"945",1038,"Bruino",999,4147,4286,8433
"946",16041,"Brumano",999,73,56,129
"947",13032,"Brunate",999,801,807,1608
"948",12023,"Brunello",999,451,467,918
"949",21013,"Brunico/Bruneck",999,8482,8661,17143
"950",5010,"Bruno",999,148,156,304
"951",16042,"Brusaporto",999,2773,2859,5632
"952",1039,"Brusasco",999,759,735,1494
"953",63010,"Brusciano",999,7816,8047,15863
"954",12024,"Brusimpiano",999,597,582,1179
"955",96007,"Brusnengo",999,928,982,1910
"956",7012,"Brusson",999,400,413,813
"957",1040,"Bruzolo",999,739,746,1485
"958",80015,"Bruzzano Zeffirio",999,492,530,1022
"959",15035,"Bubbiano",999,1247,1216,2463
"960",5011,"Bubbio",999,391,418,809
"961",89003,"Buccheri",999,820,905,1725
"962",69008,"Bucchianico",999,2423,2496,4919
"963",62010,"Bucciano",999,958,1009,1967
"964",15036,"Buccinasco",999,12906,13758,26664
"965",65017,"Buccino",999,2230,2283,4513
"966",51005,"Bucine",999,4908,5022,9930
"967",90017,"Buddusò",999,1788,1752,3540
"968",93008,"Budoia",999,1248,1272,2520
"969",90091,"Budoni",999,2737,2785,5522
"970",37008,"Budrio",999,9008,9354,18362
"971",111006,"Buggerru",999,529,498,1027
"972",47003,"Buggiano",999,4236,4540,8776
"973",14010,"Buglio in Monte",999,1008,1005,2013
"974",66012,"Bugnara",999,510,500,1010
"975",12025,"Buguggiate",999,1514,1598,3112
"976",30013,"Buja",999,3072,3265,6337
"977",97011,"Bulciago",999,1499,1427,2926
"978",13034,"Bulgarograsso",999,2024,1983,4007
"979",90018,"Bultei",999,393,412,805
"980",90019,"Bulzi",999,241,217,458
"981",65018,"Buonabitacolo",999,1183,1247,2430
"982",62011,"Buonalbergo",999,751,756,1507
"983",52003,"Buonconvento",999,1439,1537,2976
"984",78020,"Buonvicino",999,962,1033,1995
"985",108013,"Burago di Molgora",999,2077,2180,4257
"986",111007,"Burcei",999,1312,1300,2612
"987",84005,"Burgio",999,1198,1282,2480
"988",90020,"Burgos",999,410,424,834
"989",1041,"Buriasco",999,645,676,1321
"990",1042,"Burolo",999,529,589,1118
"991",2021,"Buronzo",999,438,427,865
"992",95017,"Busachi",999,552,579,1131
"993",10006,"Busalla",999,2530,2578,5108
"994",1043,"Busano",999,812,775,1587
"995",4034,"Busca",999,5130,5029,10159
"996",15038,"Buscate",999,2328,2352,4680
"997",89004,"Buscemi",999,484,465,949
"998",81002,"Buseto Palizzolo",999,1342,1416,2758
"999",108051,"Busnago",999,3414,3457,6871
"1000",15040,"Bussero",999,4005,4323,8328
"1001",34007,"Busseto",999,3439,3402,6841
"1002",68005,"Bussi sul Tirino",999,1114,1155,2269
"1003",70005,"Busso",999,584,575,1159
"1004",23015,"Bussolengo",999,10219,10655,20874
"1005",1044,"Bussoleno",999,2765,2949,5714
"1006",12026,"Busto Arsizio",999,40279,43160,83439
"1007",15041,"Busto Garolfo",999,7000,7042,14042
"1008",85003,"Butera",999,2017,2106,4123
"1009",50002,"Buti",999,2716,2809,5525
"1010",23016,"Buttapietra",999,3542,3469,7011
"1011",1045,"Buttigliera Alta",999,3052,3151,6203
"1012",5012,"Buttigliera d'Asti",999,1283,1236,2519
"1013",30014,"Buttrio",999,1946,1980,3926
"1014",6025,"Cabella Ligure",999,232,224,456
"1015",13035,"Cabiate",999,3648,3690,7338
"1016",95018,"Cabras",999,4442,4379,8821
"1017",82014,"Caccamo",999,3741,3871,7612
"1018",101002,"Caccuri",999,759,774,1533
"1019",12027,"Cadegliano-Viconago",999,1049,1124,2173
"1020",35008,"Cadelbosco di Sopra",999,5269,5450,10719
"1021",33007,"Cadeo",999,2976,3027,6003
"1022",22029,"Caderzone Terme",999,359,337,696
"1023",28016,"Cadoneghe",999,7661,8145,15806
"1024",13036,"Cadorago",999,3932,4007,7939
"1025",12143,"Cadrezzate con Osmate",999,1297,1377,2674
"1026",26006,"Caerano di San Marco",999,3838,3950,7788
"1027",1046,"Cafasse",999,1640,1662,3302
"1028",65019,"Caggiano",999,1254,1248,2502
"1029",41007,"Cagli",999,3891,4060,7951
"1030",92009,"Cagliari",999,68689,78689,147378
"1031",13037,"Caglio",999,244,246,490
"1032",66013,"Cagnano Amiterno",999,556,550,1106
"1033",71008,"Cagnano Varano",999,3223,3353,6576
"1034",61008,"Caianello",999,872,890,1762
"1035",61009,"Caiazzo",999,2512,2633,5145
"1036",21014,"Caines/Kuens",999,191,198,389
"1037",17031,"Caino",999,1127,1060,2187
"1038",14011,"Caiolo",999,535,513,1048
"1039",64013,"Cairano",999,140,148,288
"1040",12029,"Cairate",999,3855,3967,7822
"1041",9015,"Cairo Montenotte",999,6354,6412,12766
"1042",63011,"Caivano",999,17773,18223,35996
"1043",64014,"Calabritto",999,1049,1091,2140
"1044",25008,"Calalzo di Cadore",999,892,945,1837
"1045",5013,"Calamandrana",999,815,856,1671
"1046",84006,"Calamonaci",999,564,581,1145
"1047",90021,"Calangianus",999,1892,1903,3795
"1048",80016,"Calanna",999,375,377,752
"1049",103014,"Calasca-Castiglione",999,300,296,596
"1050",86005,"Calascibetta",999,1973,2058,4031
"1051",66014,"Calascio",999,67,57,124
"1052",111008,"Calasetta",999,1407,1401,2808
"1053",87010,"Calatabiano",999,2535,2584,5119
"1054",81003,"Calatafimi-Segesta",999,2990,3066,6056
"1055",56010,"Calcata",999,441,472,913
"1056",22032,"Calceranica al Lago",999,692,703,1395
"1057",50003,"Calci",999,3032,3278,6310
"1058",77004,"Calciano",999,328,327,655
"1059",50004,"Calcinaia",999,6261,6561,12822
"1060",16043,"Calcinate",999,3199,3013,6212
"1061",17032,"Calcinato",999,6605,6433,13038
"1062",16044,"Calcio",999,2853,2635,5488
"1063",97012,"Calco",999,2735,2691,5426
"1064",43006,"Caldarola",999,796,807,1603
"1065",21015,"Caldaro sulla strada del vino/Kaltern an der Weinstraße",999,4001,4160,8161
"1066",37009,"Calderara di Reno",999,6698,6956,13654
"1067",22033,"Caldes",999,550,556,1106
"1068",23017,"Caldiero",999,4055,3979,8034
"1069",24018,"Caldogno",999,5561,5787,11348
"1070",22034,"Caldonazzo",999,1934,2028,3962
"1071",33008,"Calendasco",999,1221,1192,2413
"1072",48005,"Calenzano",999,8945,9185,18130
"1073",34008,"Calestano",999,1102,999,2101
"1074",11008,"Calice al Cornoviglio",999,533,527,1060
"1075",9016,"Calice Ligure",999,821,872,1693
"1076",75010,"Calimera",999,3161,3540,6701
"1077",64015,"Calitri",999,2030,2153,4183
"1078",9017,"Calizzano",999,712,727,1439
"1079",96008,"Callabiana",999,74,65,139
"1080",22035,"Calliano",999,1042,996,2038
"1081",5014,"Calliano Monferrato",999,607,612,1219
"1082",97013,"Calolziocorte",999,6667,6941,13608
"1083",78021,"Calopezzati",999,615,632,1247
"1084",5015,"Calosso",999,580,536,1116
"1085",78022,"Caloveto",999,537,554,1091
"1086",84007,"Caltabellotta",999,1520,1628,3148
"1087",87011,"Caltagirone",999,17505,18123,35628
"1088",85004,"Caltanissetta",999,28326,30016,58342
"1089",82015,"Caltavuturo",999,1679,1758,3437
"1090",3030,"Caltignaga",999,1231,1246,2477
"1091",29008,"Calto",999,338,344,682
"1092",24019,"Caltrano",999,1253,1271,2524
"1093",16046,"Calusco d'Adda",999,4156,4181,8337
"1094",1047,"Caluso",999,3606,3768,7374
"1095",17033,"Calvagese della Riviera",999,1851,1852,3703
"1096",65020,"Calvanico",999,699,695,1394
"1097",19009,"Calvatone",999,604,550,1154
"1098",76015,"Calvello",999,862,928,1790
"1099",24020,"Calvene",999,638,639,1277
"1100",16047,"Calvenzano",999,2231,2220,4451
"1101",76016,"Calvera",999,182,173,355
"1102",62012,"Calvi",999,1237,1264,2501
"1103",55008,"Calvi dell'Umbria",999,817,859,1676
"1104",18025,"Calvignano",999,52,56,108
"1105",15042,"Calvignasco",999,607,597,1204
"1106",61010,"Calvi Risorta",999,2590,2813,5403
"1107",17034,"Calvisano",999,4268,4113,8381
"1108",63012,"Calvizzano",999,6182,6275,12457
"1109",6026,"Camagna Monferrato",999,220,245,465
"1110",46005,"Camaiore",999,15384,16476,31860
"1111",96009,"Camandona",999,155,153,308
"1112",84008,"Camastra",999,1010,982,1992
"1113",15044,"Cambiago",999,3625,3598,7223
"1114",1048,"Cambiano",999,2848,3043,5891
"1115",103015,"Cambiasca",999,765,816,1581
"1116",96010,"Camburzano",999,542,566,1108
"1117",4035,"Camerana",999,283,274,557
"1118",42006,"Camerano",999,3445,3625,7070
"1119",5016,"Camerano Casasco",999,200,192,392
"1120",16048,"Camerata Cornello",999,275,276,551
"1121",58014,"Camerata Nuova",999,223,190,413
"1122",42007,"Camerata Picena",999,1250,1243,2493
"1123",3032,"Cameri",999,5219,5499,10718
"1124",43007,"Camerino",999,2971,3128,6099
"1125",65021,"Camerota",999,3381,3448,6829
"1126",61011,"Camigliano",999,988,982,1970
"1127",80017,"Camini",999,390,407,797
"1128",6027,"Camino",999,379,360,739
"1129",30015,"Camino al Tagliamento",999,764,769,1533
"1130",19010,"Camisano",999,622,621,1243
"1131",24021,"Camisano Vicentino",999,5511,5654,11165
"1132",84009,"Cammarata",999,2898,2939,5837
"1133",10007,"Camogli",999,2431,2504,4935
"1134",65022,"Campagna",999,8453,8306,16759
"1135",27002,"Campagna Lupia",999,3537,3654,7191
"1136",58015,"Campagnano di Roma",999,5324,5669,10993
"1137",53002,"Campagnatico",999,1232,1108,2340
"1138",19011,"Campagnola Cremasca",999,323,328,651
"1139",35009,"Campagnola Emilia",999,2763,2792,5555
"1140",78023,"Campana",999,701,729,1430
"1141",108014,"Camparada",999,1110,1024,2134
"1142",35010,"Campegine",999,2643,2709,5352
"1143",54005,"Campello sul Clitunno",999,1128,1189,2317
"1144",2025,"Campertogno",999,109,117,226
"1145",48006,"Campi Bisenzio",999,23589,23972,47561
"1146",96086,"Campiglia Cervo",999,263,237,500
"1147",24022,"Campiglia dei Berici",999,834,833,1667
"1148",49002,"Campiglia Marittima",999,5990,6426,12416
"1149",1049,"Campiglione Fenile",999,643,667,1310
"1150",13040,"Campione d'Italia",999,864,929,1793
"1151",75011,"Campi Salentina",999,4675,5045,9720
"1152",22036,"Campitello di Fassa",999,343,357,700
"1153",67008,"Campli",999,3300,3256,6556
"1154",70006,"Campobasso",999,22965,24484,47449
"1155",84010,"Campobello di Licata",999,4387,4635,9022
"1156",81004,"Campobello di Mazara",999,5677,5663,11340
"1157",80018,"Campo Calabro",999,2195,2273,4468
"1158",70007,"Campochiaro",999,282,296,578
"1159",28017,"Campodarsego",999,7484,7600,15084
"1160",22037,"Campodenno",999,787,722,1509
"1161",66015,"Campo di Giove",999,384,362,746
"1162",59003,"Campodimele",999,296,268,564
"1163",70008,"Campodipietra",999,1183,1243,2426
"1164",21016,"Campo di Trens/Freienfeld",999,1407,1301,2708
"1165",14012,"Campodolcino",999,473,469,942
"1166",28018,"Campodoro",999,1300,1302,2602
"1167",82016,"Campofelice di Fitalia",999,225,211,436
"1168",82017,"Campofelice di Roccella",999,3840,3904,7744
"1169",109004,"Campofilone",999,958,949,1907
"1170",82018,"Campofiorito",999,551,580,1131
"1171",30016,"Campoformido",999,3855,4014,7869
"1172",85005,"Campofranco",999,1222,1374,2596
"1173",36003,"Campogalliano",999,4241,4306,8547
"1174",62013,"Campolattaro",999,483,493,976
"1175",60016,"Campoli Appennino",999,798,814,1612
"1176",62014,"Campoli del Monte Taburno",999,920,716,1636
"1177",70009,"Campolieto",999,459,404,863
"1178",10008,"Campo Ligure",999,1438,1388,2826
"1179",27003,"Campolongo Maggiore",999,5357,5383,10740
"1180",30138,"Campolongo Tapogliano",999,545,557,1102
"1181",76017,"Campomaggiore",999,338,366,704
"1182",70010,"Campomarino",999,4053,3814,7867
"1183",10009,"Campomorone",999,3158,3303,6461
"1184",49003,"Campo nell'Elba",999,2315,2362,4677
"1185",27004,"Camponogara",999,6377,6623,13000
"1186",65023,"Campora",999,157,155,312
"1187",82019,"Camporeale",999,1455,1476,2931
"1188",46006,"Camporgiano",999,997,1007,2004
"1189",8011,"Camporosso",999,2747,2864,5611
"1190",43008,"Camporotondo di Fiastrone",999,222,249,471
"1191",87012,"Camporotondo Etneo",999,2608,2568,5176
"1192",28019,"Camposampiero",999,5887,5966,11853
"1193",28020,"Campo San Martino",999,2833,2774,5607
"1194",63013,"Camposano",999,2407,2602,5009
"1195",36004,"Camposanto",999,1663,1636,3299
"1196",18026,"Campospinoso",999,541,576,1117
"1197",66016,"Campotosto",999,239,220,459
"1198",21017,"Campo Tures/Sand in Taufers",999,2846,2884,5730
"1199",37010,"Camugnano",999,939,930,1869
"1200",4037,"Canale",999,2726,2779,5505
"1201",25023,"Canale d'Agordo",999,525,533,1058
"1202",58016,"Canale Monterano",999,2032,2119,4151
"1203",22038,"Canal San Bovo",999,709,753,1462
"1204",29009,"Canaro",999,1255,1278,2533
"1205",22039,"Canazei",999,875,957,1832
"1206",76018,"Cancellara",999,565,566,1131
"1207",61012,"Cancello ed Arnone",999,2934,2743,5677
"1208",29010,"Canda",999,409,414,823
"1209",71009,"Candela",999,1269,1235,2504
"1210",96012,"Candelo",999,3497,3751,7248
"1211",1050,"Candia Canavese",999,578,612,1190
"1212",18027,"Candia Lomellina",999,781,717,1498
"1213",28021,"Candiana",999,1136,1068,2204
"1214",64016,"Candida",999,571,532,1103
"1215",80019,"Candidoni",999,218,201,419
"1216",1051,"Candiolo",999,2788,2828,5616
"1217",15046,"Canegrate",999,6112,6453,12565
"1218",5017,"Canelli",999,4900,5129,10029
"1219",56011,"Canepina",999,1440,1480,2920
"1220",93009,"Caneva",999,3070,3165,6235
"1221",84011,"Canicattì",999,16749,17698,34447
"1222",89005,"Canicattini Bagni",999,3106,3382,6488
"1223",56012,"Canino",999,2521,2484,5005
"1224",1052,"Canischio",999,140,129,269
"1225",66017,"Canistro",999,442,452,894
"1226",78024,"Canna",999,295,314,609
"1227",65024,"Cannalonga",999,477,461,938
"1228",54006,"Cannara",999,2026,2144,4170
"1229",103016,"Cannero Riviera",999,469,451,920
"1230",18029,"Canneto Pavese",999,643,643,1286
"1231",20008,"Canneto sull'Oglio",999,2190,2128,4318
"1232",103017,"Cannobio",999,2457,2581,5038
"1233",75012,"Cannole",999,786,782,1568
"1234",80020,"Canolo",999,344,344,688
"1235",16049,"Canonica d'Adda",999,2227,2059,4286
"1236",110004,"Canosa di Puglia",999,13709,13971,27680
"1237",69010,"Canosa Sannita",999,608,633,1241
"1238",4038,"Canosio",999,41,35,76
"1239",35018,"Canossa",999,1927,1852,3779
"1240",66018,"Cansano",999,98,116,214
"1241",100001,"Cantagallo",999,1624,1507,3131
"1242",57009,"Cantalice",999,1224,1232,2456
"1243",1053,"Cantalupa",999,1276,1323,2599
"1244",57010,"Cantalupo in Sabina",999,822,840,1662
"1245",6028,"Cantalupo Ligure",999,222,226,448
"1246",94005,"Cantalupo nel Sannio",999,397,318,715
"1247",5018,"Cantarana",999,473,484,957
"1248",12030,"Cantello",999,2328,2446,4774
"1249",58017,"Canterano",999,198,172,370
"1250",41008,"Cantiano",999,999,992,1991
"1251",1054,"Cantoira",999,340,285,625
"1252",13041,"Cantù",999,19691,20332,40023
"1253",67009,"Canzano",999,885,885,1770
"1254",13042,"Canzo",999,2504,2623,5127
"1255",27005,"Caorle",999,5335,5761,11096
"1256",33010,"Caorso",999,2395,2380,4775
"1257",65025,"Capaccio Paestum",999,11351,11013,22364
"1258",82020,"Capaci",999,5614,5734,11348
"1259",53003,"Capalbio",999,1839,1957,3796
"1260",50005,"Capannoli",999,3124,3246,6370
"1261",46007,"Capannori",999,22917,23426,46343
"1262",58018,"Capena",999,5494,5366,10860
"1263",19012,"Capergnanica",999,1095,1045,2140
"1264",66019,"Capestrano",999,396,427,823
"1265",13043,"Capiago Intimiano",999,2657,2782,5439
"1266",102005,"Capistrano",999,464,491,955
"1267",66020,"Capistrello",999,2301,2442,4743
"1268",66021,"Capitignano",999,314,312,626
"1269",83008,"Capizzi",999,1370,1445,2815
"1270",16050,"Capizzone",999,606,602,1208
"1271",56013,"Capodimonte",999,824,847,1671
"1272",17035,"Capo di Ponte",999,1108,1186,2294
"1273",83009,"Capo d'Orlando",999,6174,6931,13105
"1274",61013,"Capodrise",999,4949,5081,10030
"1275",49004,"Capoliveri",999,1944,1968,3912
"1276",51006,"Capolona",999,2551,2685,5236
"1277",108052,"Caponago",999,2552,2570,5122
"1278",66022,"Caporciano",999,108,94,202
"1279",64017,"Caposele",999,1587,1644,3231
"1280",92011,"Capoterra",999,11519,11656,23175
"1281",17036,"Capovalle",999,167,168,335
"1282",66023,"Cappadocia",999,334,244,578
"1283",19013,"Cappella Cantone",999,267,278,545
"1284",19014,"Cappella de' Picenardi",999,220,186,406
"1285",26007,"Cappella Maggiore",999,2276,2338,4614
"1286",68006,"Cappelle sul Tavo",999,1988,2056,4044
"1287",94006,"Capracotta",999,396,382,778
"1288",48008,"Capraia e Limite",999,3857,3969,7826
"1289",49005,"Capraia Isola",999,208,164,372
"1290",19015,"Capralba",999,1146,1138,2284
"1291",56014,"Capranica",999,3092,3282,6374
"1292",58019,"Capranica Prenestina",999,174,142,316
"1293",75013,"Caprarica di Lecce",999,1067,1176,2243
"1294",56015,"Caprarola",999,2552,2601,5153
"1295",4039,"Caprauna",999,43,39,82
"1296",51007,"Caprese Michelangelo",999,648,689,1337
"1297",103018,"Caprezzo",999,95,80,175
"1298",63014,"Capri",999,3357,3429,6786
"1299",22040,"Capriana",999,303,292,595
"1300",17037,"Capriano del Colle",999,2449,2348,4797
"1301",6029,"Capriata d'Orba",999,881,879,1760
"1302",16051,"Capriate San Gervasio",999,4175,4067,8242
"1303",61014,"Capriati a Volturno",999,679,733,1412
"1304",1055,"Caprie",999,1026,996,2022
"1305",64018,"Capriglia Irpina",999,1099,1116,2215
"1306",5019,"Capriglio",999,175,133,308
"1307",96013,"Caprile",999,99,88,187
"1308",83010,"Capri Leone",999,2097,2265,4362
"1309",16052,"Caprino Bergamasco",999,1585,1465,3050
"1310",23018,"Caprino Veronese",999,4273,4410,8683
"1311",17038,"Capriolo",999,4709,4674,9383
"1312",31001,"Capriva del Friuli",999,769,848,1617
"1313",61015,"Capua",999,8703,9088,17791
"1314",72014,"Capurso",999,7355,7816,15171
"1315",80021,"Caraffa del Bianco",999,210,240,450
"1316",79017,"Caraffa di Catanzaro",999,863,839,1702
"1317",4040,"Caraglio",999,3397,3366,6763
"1318",4041,"Caramagna Piemonte",999,1510,1508,3018
"1319",68007,"Caramanico Terme",999,892,868,1760
"1320",71010,"Carapelle",999,3476,3465,6941
"1321",66024,"Carapelle Calvisio",999,40,38,78
"1322",10010,"Carasco",999,1836,1910,3746
"1323",44010,"Carassai",999,485,496,981
"1324",108015,"Carate Brianza",999,8802,9144,17946
"1325",13044,"Carate Urio",999,542,573,1115
"1326",16053,"Caravaggio",999,8083,8255,16338
"1327",12031,"Caravate",999,1251,1286,2537
"1328",1056,"Caravino",999,427,460,887
"1329",8012,"Caravonica",999,138,107,245
"1330",56016,"Carbognano",999,943,1013,1956
"1331",18030,"Carbonara al Ticino",999,710,730,1440
"1332",63015,"Carbonara di Nola",999,1232,1212,2444
"1333",6030,"Carbonara Scrivia",999,553,565,1118
"1334",13045,"Carbonate",999,1470,1458,2928
"1335",76019,"Carbone",999,248,250,498
"1336",26008,"Carbonera",999,5525,5694,11219
"1337",111009,"Carbonia",999,12427,13563,25990
"1338",9018,"Carcare",999,2509,2796,5305
"1339",28022,"Carceri",999,733,740,1473
"1340",2029,"Carcoforo",999,38,37,75
"1341",12032,"Cardano al Campo",999,7267,7486,14753
"1342",4042,"Cardè",999,552,581,1133
"1343",91103,"Cardedu",999,955,1009,1964
"1344",80022,"Cardeto",999,611,671,1282
"1345",79018,"Cardinale",999,864,940,1804
"1346",63016,"Cardito",999,10588,10947,21535
"1347",46008,"Careggine",999,251,253,504
"1348",1057,"Carema",999,354,379,733
"1349",97014,"Carenno",999,683,708,1391
"1350",6031,"Carentino",999,165,156,321
"1351",80023,"Careri",999,1017,1071,2088
"1352",2030,"Caresana",999,616,462,1078
"1353",2031,"Caresanablot",999,528,556,1084
"1354",6032,"Carezzano",999,212,218,430
"1355",101003,"Carfizzi",999,234,267,501
"1356",90022,"Cargeghe",999,294,291,585
"1357",78025,"Cariati",999,3652,3836,7488
"1358",64019,"Carife",999,608,653,1261
"1359",1058,"Carignano",999,4510,4621,9131
"1360",13046,"Carimate",999,2193,2221,4414
"1361",61016,"Carinaro",999,3473,3619,7092
"1362",82021,"Carini",999,20010,20140,40150
"1363",61017,"Carinola",999,3575,3500,7075
"1364",2032,"Carisio",999,389,370,759
"1365",22042,"Carisolo",999,445,476,921
"1366",71011,"Carlantino",999,376,409,785
"1367",13047,"Carlazzo",999,1545,1677,3222
"1368",89006,"Carlentini",999,8258,8771,17029
"1369",30018,"Carlino",999,1290,1339,2629
"1370",111010,"Carloforte",999,2922,2977,5899
"1371",79020,"Carlopoli",999,686,672,1358
"1372",1059,"Carmagnola",999,13762,14364,28126
"1373",75014,"Carmiano",999,5728,5924,11652
"1374",100002,"Carmignano",999,7294,7411,14705
"1375",28023,"Carmignano di Brenta",999,3739,3680,7419
"1376",12033,"Carnago",999,3268,3337,6605
"1377",108016,"Carnate",999,3954,3890,7844
"1378",16055,"Carobbio degli Angeli",999,2478,2428,4906
"1379",78026,"Carolei",999,1559,1544,3103
"1380",16056,"Carona",999,132,150,282
"1381",83011,"Caronia",999,1448,1555,3003
"1382",12034,"Caronno Pertusella",999,9033,9251,18284
"1383",12035,"Caronno Varesino",999,2420,2413,4833
"1384",73002,"Carosino",999,3202,3330,6532
"1385",74002,"Carovigno",999,8537,8438,16975
"1386",94007,"Carovilli",999,629,613,1242
"1387",33011,"Carpaneto Piacentino",999,3824,3870,7694
"1388",78027,"Carpanzano",999,91,104,195
"1389",41009,"Carpegna",999,911,827,1738
"1390",17039,"Carpenedolo",999,6594,6439,13033
"1391",6033,"Carpeneto",999,440,434,874
"1392",36005,"Carpi",999,35616,36909,72525
"1393",15050,"Carpiano",999,2138,2004,4142
"1394",75015,"Carpignano Salentino",999,1809,1818,3627
"1395",3036,"Carpignano Sesia",999,1161,1306,2467
"1396",35011,"Carpineti",999,1947,1971,3918
"1397",68008,"Carpineto della Nora",999,262,267,529
"1398",58020,"Carpineto Romano",999,1947,2052,3999
"1399",69011,"Carpineto Sinello",999,228,227,455
"1400",71012,"Carpino",999,1881,1895,3776
"1401",94008,"Carpinone",999,488,530,1018
"1402",45003,"Carrara",999,28980,30813,59793
"1403",24024,"Carrè",999,1713,1746,3459
"1404",6034,"Carrega Ligure",999,48,34,82
"1405",11009,"Carro",999,229,254,483
"1406",11010,"Carrodano",999,232,232,464
"1407",6035,"Carrosio",999,260,236,496
"1408",4043,"Carrù",999,2217,2200,4417
"1409",66025,"Carsoli",999,2489,2498,4987
"1410",24025,"Cartigliano",999,1819,1838,3657
"1411",4044,"Cartignano",999,79,85,164
"1412",41010,"Cartoceto",999,4037,4050,8087
"1413",6036,"Cartosio",999,347,363,710
"1414",28026,"Cartura",999,2266,2313,4579
"1415",15051,"Carugate",999,7815,7929,15744
"1416",13048,"Carugo",999,3288,3324,6612
"1417",69012,"Carunchio",999,310,241,551
"1418",16057,"Carvico",999,2318,2343,4661
"1419",22043,"Carzano",999,256,254,510
"1420",101004,"Casabona",999,1077,1188,2265
"1421",70011,"Casacalenda",999,948,895,1843
"1422",69013,"Casacanditella",999,593,584,1177
"1423",61018,"Casagiove",999,6180,6688,12868
"1424",69014,"Casalanguida",999,391,420,811
"1425",60017,"Casalattico",999,259,265,524
"1426",3037,"Casalbeltrame",999,534,479,1013
"1427",69015,"Casalbordino",999,2752,2975,5727
"1428",64020,"Casalbore",999,757,795,1552
"1429",1060,"Casalborgone",999,926,964,1890
"1430",65026,"Casalbuono",999,508,510,1018
"1431",19016,"Casalbuttano ed Uniti",999,1823,1905,3728
"1432",6037,"Casal Cermelli",999,570,607,1177
"1433",70012,"Casalciprano",999,217,226,443
"1434",61019,"Casal di Principe",999,10775,10644,21419
"1435",62015,"Casalduni",999,593,585,1178
"1436",37011,"Casalecchio di Reno",999,16832,18699,35531
"1437",103019,"Casale Corte Cerro",999,1663,1682,3345
"1438",19017,"Casale Cremasco-Vidolasco",999,944,884,1828
"1439",28027,"Casale di Scodosia",999,2333,2308,4641
"1440",6038,"Casaleggio Boiro",999,176,177,353
"1441",3039,"Casaleggio Novara",999,438,458,896
"1442",12036,"Casale Litta",999,1374,1383,2757
"1443",50006,"Casale Marittimo",999,540,536,1076
"1444",6039,"Casale Monferrato",999,15366,16851,32217
"1445",23019,"Casaleone",999,2833,2766,5599
"1446",26009,"Casale sul Sile",999,6462,6630,13092
"1447",19018,"Casaletto Ceredano",999,567,568,1135
"1448",19019,"Casaletto di Sopra",999,265,245,510
"1449",98008,"Casaletto Lodigiano",999,1521,1476,2997
"1450",65027,"Casaletto Spartano",999,611,651,1262
"1451",19020,"Casaletto Vaprio",999,875,916,1791
"1452",37012,"Casalfiumanese",999,1717,1664,3381
"1453",35012,"Casalgrande",999,9493,9460,18953
"1454",4045,"Casalgrasso",999,743,704,1447
"1455",78156,"Casali del Manco",999,4692,4730,9422
"1456",69016,"Casalincontrada",999,1470,1508,2978
"1457",3040,"Casalino",999,783,729,1512
"1458",19021,"Casalmaggiore",999,7645,7528,15173
"1459",98009,"Casalmaiocco",999,1569,1626,3195
"1460",19022,"Casalmorano",999,815,859,1674
"1461",20010,"Casalmoro",999,1136,1070,2206
"1462",6040,"Casalnoceto",999,486,483,969
"1463",63017,"Casalnuovo di Napoli",999,22868,24024,46892
"1464",71013,"Casalnuovo Monterotaro",999,678,695,1373
"1465",20011,"Casaloldo",999,1292,1319,2611
"1466",98010,"Casalpusterlengo",999,7808,7800,15608
"1467",20012,"Casalromano",999,746,743,1489
"1468",28028,"Casalserugo",999,2674,2686,5360
"1469",61020,"Casaluce",999,4702,4842,9544
"1470",71014,"Casalvecchio di Puglia",999,824,833,1657
"1471",83012,"Casalvecchio Siculo",999,381,333,714
"1472",65028,"Casal Velino",999,2709,2673,5382
"1473",60018,"Casalvieri",999,1223,1219,2442
"1474",3041,"Casalvolone",999,446,424,870
"1475",12037,"Casalzuigno",999,676,684,1360
"1476",63018,"Casamarciano",999,1512,1505,3017
"1477",72015,"Casamassima",999,9477,9724,19201
"1478",63019,"Casamicciola Terme",999,3725,3863,7588
"1479",63020,"Casandrino",999,6686,6349,13035
"1480",2033,"Casanova Elvo",999,118,101,219
"1481",9019,"Casanova Lerrone",999,364,375,739
"1482",18031,"Casanova Lonati",999,243,220,463
"1483",58021,"Casape",999,304,308,612
"1484",61103,"Casapesenna",999,3511,3514,7025
"1485",96014,"Casapinta",999,170,206,376
"1486",57011,"Casaprota",999,333,337,670
"1487",61021,"Casapulla",999,3999,4256,8255
"1488",75016,"Casarano",999,9102,10030,19132
"1489",97015,"Casargo",999,418,419,837
"1490",15055,"Casarile",999,1955,1996,3951
"1491",93010,"Casarsa della Delizia",999,4154,4143,8297
"1492",10011,"Casarza Ligure",999,3327,3405,6732
"1493",6041,"Casasco",999,63,58,121
"1494",97016,"Casatenovo",999,6524,6756,13280
"1495",18032,"Casatisma",999,424,428,852
"1496",63021,"Casavatore",999,8825,9349,18174
"1497",16058,"Casazza",999,1875,1914,3789
"1498",54007,"Cascia",999,1456,1517,2973
"1499",12038,"Casciago",999,1738,1849,3587
"1500",50040,"Casciana Terme Lari",999,6014,6186,12200
"1501",50008,"Cascina",999,21783,23031,44814
"1502",1061,"Cascinette d'Ivrea",999,726,799,1525
"1503",18033,"Casei Gerola",999,1140,1147,2287
"1504",1062,"Caselette",999,1511,1516,3027
"1505",10012,"Casella",999,1573,1498,3071
"1506",65029,"Caselle in Pittari",999,915,954,1869
"1507",98011,"Caselle Landi",999,732,721,1453
"1508",98012,"Caselle Lurani",999,1584,1484,3068
"1509",1063,"Caselle Torinese",999,6835,6966,13801
"1510",61022,"Caserta",999,34140,38345,72485
"1511",26010,"Casier",999,5648,5788,11436
"1512",80024,"Casignana",999,322,347,669
"1513",35013,"Casina",999,2283,2267,4550
"1514",16059,"Casirate d'Adda",999,2066,2018,4084
"1515",13052,"Caslino d'Erba",999,812,855,1667
"1516",13053,"Casnate con Bernate",999,2461,2583,5044
"1517",16060,"Casnigo",999,1535,1506,3041
"1518",63022,"Casola di Napoli",999,1786,1850,3636
"1519",45004,"Casola in Lunigiana",999,452,481,933
"1520",39005,"Casola Valsenio",999,1355,1186,2541
"1521",52004,"Casole d'Elsa",999,1851,1864,3715
"1522",69017,"Casoli",999,2513,2598,5111
"1523",18034,"Casorate Primo",999,4515,4523,9038
"1524",12039,"Casorate Sempione",999,2716,2893,5609
"1525",15058,"Casorezzo",999,2750,2893,5643
"1526",63023,"Casoria",999,35710,38097,73807
"1527",5020,"Casorzo Monferrato",999,282,303,585
"1528",57012,"Casperia",999,588,611,1199
"1529",14013,"Caspoggio",999,663,677,1340
"1530",30019,"Cassacco",999,1367,1427,2794
"1531",97017,"Cassago Brianza",999,2235,2196,4431
"1532",78029,"Cassano all'Ionio",999,8294,8171,16465
"1533",15059,"Cassano d'Adda",999,9574,9916,19490
"1534",72016,"Cassano delle Murge",999,7486,7604,15090
"1535",64021,"Cassano Irpino",999,479,478,957
"1536",12040,"Cassano Magnago",999,10511,10817,21328
"1537",6191,"Cassano Spinola",999,874,918,1792
"1538",12041,"Cassano Valcuvia",999,332,325,657
"1539",89007,"Cassaro",999,354,365,719
"1540",16061,"Cassiglio",999,50,54,104
"1541",15060,"Cassina de' Pecchi",999,6787,7144,13931
"1542",13055,"Cassina Rizzardi",999,1607,1684,3291
"1543",5021,"Cassinasco",999,297,252,549
"1544",97018,"Cassina Valsassina",999,278,263,541
"1545",6043,"Cassine",999,1435,1364,2799
"1546",6044,"Cassinelle",999,448,403,851
"1547",15061,"Cassinetta di Lugagnano",999,933,984,1917
"1548",60019,"Cassino",999,17269,17770,35039
"1549",24026,"Cassola",999,7462,7796,15258
"1550",18035,"Cassolnovo",999,3355,3411,6766
"1551",23020,"Castagnaro",999,1751,1782,3533
"1552",49006,"Castagneto Carducci",999,4299,4417,8716
"1553",1064,"Castagneto Po",999,914,863,1777
"1554",4046,"Castagnito",999,1104,1135,2239
"1555",5022,"Castagnole delle Lanze",999,1792,1876,3668
"1556",5023,"Castagnole Monferrato",999,558,553,1111
"1557",1065,"Castagnole Piemonte",999,1112,1095,2207
"1558",18036,"Castana",999,345,372,717
"1559",15062,"Castano Primo",999,5399,5461,10860
"1560",18037,"Casteggio",999,3098,3380,6478
"1561",17040,"Castegnato",999,4170,4209,8379
"1562",24027,"Castegnero",999,1449,1396,2845
"1563",28029,"Castelbaldo",999,716,730,1446
"1564",64022,"Castel Baronia",999,511,540,1051
"1565",20013,"Castelbelforte",999,1674,1637,3311
"1566",42008,"Castelbellino",999,2396,2550,4946
"1567",21018,"Castelbello-Ciardes/Kastelbell-Tschars",999,1204,1162,2366
"1568",9020,"Castelbianco",999,163,158,321
"1569",5024,"Castel Boglione",999,310,263,573
"1570",39006,"Castel Bolognese",999,4726,4805,9531
"1571",70013,"Castelbottaccio",999,110,126,236
"1572",82022,"Castelbuono",999,3921,4095,8016
"1573",61023,"Castel Campagnano",999,687,753,1440
"1574",67010,"Castel Castagna",999,214,211,425
"1575",65030,"Castelcivita",999,716,678,1394
"1576",22045,"Castel Condino",999,113,112,225
"1577",17041,"Castelcovati",999,3510,3422,6932
"1578",26011,"Castelcucco",999,1171,1162,2333
"1579",82023,"Casteldaccia",999,5751,5901,11652
"1580",37013,"Castel d'Aiano",999,977,929,1906
"1581",20014,"Castel d'Ario",999,2279,2373,4652
"1582",23021,"Castel d'Azzano",999,5958,6137,12095
"1583",99021,"Casteldelci",999,184,180,364
"1584",4047,"Casteldelfino",999,68,71,139
"1585",94009,"Castel del Giudice",999,159,142,301
"1586",66026,"Castel del Monte",999,235,187,422
"1587",53004,"Castel del Piano",999,2426,2373,4799
"1588",37014,"Castel del Rio",999,587,617,1204
"1589",37015,"Castel di Casio",999,1652,1686,3338
"1590",19023,"Casteldidone",999,280,266,546
"1591",66027,"Castel di Ieri",999,137,156,293
"1592",87013,"Castel di Iudica",999,2086,2173,4259
"1593",44011,"Castel di Lama",999,4171,4261,8432
"1594",83013,"Castel di Lucio",999,666,659,1325
"1595",66028,"Castel di Sangro",999,3393,3223,6616
"1596",61024,"Castel di Sasso",999,510,525,1035
"1597",57013,"Castel di Tora",999,146,128,274
"1598",42010,"Castelfidardo",999,9080,9364,18444
"1599",48010,"Castelfiorentino",999,8501,8792,17293
"1600",51008,"Castel Focognano",999,1475,1468,2943
"1601",59004,"Castelforte",999,1984,2089,4073
"1602",64023,"Castelfranci",999,858,882,1740
"1603",50009,"Castelfranco di Sotto",999,6851,6784,13635
"1604",36006,"Castelfranco Emilia",999,16911,16507,33418
"1605",62016,"Castelfranco in Miscano",999,392,381,773
"1606",51040,"Castelfranco Piandiscò",999,4765,4980,9745
"1607",26012,"Castelfranco Veneto",999,16182,16921,33103
"1608",69018,"Castel Frentano",999,2049,2215,4264
"1609",19024,"Castel Gabbiano",999,274,227,501
"1610",58022,"Castel Gandolfo",999,4059,4592,8651
"1611",98062,"Castelgerundo",999,719,723,1442
"1612",55009,"Castel Giorgio",999,941,1057,1998
"1613",20015,"Castel Goffredo",999,6448,6345,12793
"1614",24028,"Castelgomberto",999,3090,3019,6109
"1615",76021,"Castelgrande",999,421,384,805
"1616",37016,"Castel Guelfo di Bologna",999,2269,2238,4507
"1617",29011,"Castelguglielmo",999,796,740,1536
"1618",69019,"Castelguidone",999,141,145,286
"1619",22240,"Castel Ivano",999,1631,1637,3268
"1620",65031,"Castellabate",999,4324,4338,8662
"1621",66029,"Castellafiume",999,540,502,1042
"1622",5025,"Castell'Alfero",999,1282,1325,2607
"1623",67011,"Castellalto",999,3625,3622,7247
"1624",81005,"Castellammare del Golfo",999,7368,7292,14660
"1625",63024,"Castellammare di Stabia",999,29780,32587,62367
"1626",1066,"Castellamonte",999,4822,4967,9789
"1627",72017,"Castellana Grotte",999,9556,10148,19704
"1628",82024,"Castellana Sicula",999,1406,1567,2973
"1629",73003,"Castellaneta",999,7883,8217,16100
"1630",6045,"Castellania Coppi",999,46,39,85
"1631",12042,"Castellanza",999,6684,7199,13883
"1632",35014,"Castellarano",999,7613,7641,15254
"1633",6046,"Castellar Guidobono",999,214,194,408
"1634",8014,"Castellaro",999,617,653,1270
"1635",33012,"Castell'Arquato",999,2274,2387,4661
"1636",53005,"Castell'Azzara",999,627,667,1294
"1637",6047,"Castellazzo Bormida",999,2231,2227,4458
"1638",3042,"Castellazzo Novarese",999,165,164,329
"1639",19025,"Castelleone",999,4582,4737,9319
"1640",42011,"Castelleone di Suasa",999,794,757,1551
"1641",5026,"Castellero",999,137,151,288
"1642",96015,"Castelletto Cervo",999,398,383,781
"1643",6048,"Castelletto d'Erro",999,59,70,129
"1644",18038,"Castelletto di Branduzzo",999,509,487,996
"1645",6049,"Castelletto d'Orba",999,905,910,1815
"1646",6050,"Castelletto Merli",999,235,215,450
"1647",5027,"Castelletto Molina",999,65,75,140
"1648",6051,"Castelletto Monferrato",999,704,719,1423
"1649",3043,"Castelletto sopra Ticino",999,4801,5084,9885
"1650",4049,"Castelletto Stura",999,684,687,1371
"1651",4050,"Castelletto Uzzone",999,152,147,299
"1652",67012,"Castelli",999,472,482,954
"1653",16062,"Castelli Calepio",999,5215,5166,10381
"1654",52005,"Castellina in Chianti",999,1360,1252,2612
"1655",4051,"Castellinaldo d'Alba",999,455,439,894
"1656",50010,"Castellina Marittima",999,926,914,1840
"1657",70014,"Castellino del Biferno",999,217,210,427
"1658",4052,"Castellino Tanaro",999,135,134,269
"1659",60020,"Castelliri",999,1575,1598,3173
"1660",12043,"Castello Cabiaglio",999,292,279,571
"1661",18039,"Castello d'Agogna",999,545,515,1060
"1662",37017,"Castello d'Argile",999,3368,3259,6627
"1663",14014,"Castello dell'Acqua",999,305,300,605
"1664",61025,"Castello del Matese",999,663,707,1370
"1665",5028,"Castello di Annone",999,1022,870,1892
"1666",97019,"Castello di Brianza",999,1306,1312,2618
"1667",63025,"Castello di Cisterna",999,3868,3925,7793
"1668",26013,"Castello di Godego",999,3481,3539,7020
"1669",22047,"Castello-Molina di Fiemme",999,1174,1145,2319
"1670",22048,"Castello Tesino",999,595,563,1158
"1671",20016,"Castellucchio",999,2587,2585,5172
"1672",71015,"Castelluccio dei Sauri",999,1039,983,2022
"1673",76022,"Castelluccio Inferiore",999,957,958,1915
"1674",76023,"Castelluccio Superiore",999,359,343,702
"1675",71016,"Castelluccio Valmaggiore",999,574,609,1183
"1676",83014,"Castell'Umberto",999,1362,1455,2817
"1677",58023,"Castel Madama",999,3500,3547,7047
"1678",37019,"Castel Maggiore",999,8892,9612,18504
"1679",4053,"Castelmagno",999,33,22,55
"1680",13058,"Castelmarte",999,655,602,1257
"1681",29012,"Castelmassa",999,1930,2062,3992
"1682",70015,"Castelmauro",999,550,591,1141
"1683",17042,"Castel Mella",999,5483,5386,10869
"1684",76024,"Castelmezzano",999,346,359,705
"1685",83015,"Castelmola",999,523,545,1068
"1686",61026,"Castel Morrone",999,1728,1851,3579
"1687",18040,"Castelnovetto",999,254,248,502
"1688",29013,"Castelnovo Bariano",999,1264,1301,2565
"1689",93011,"Castelnovo del Friuli",999,419,410,829
"1690",35015,"Castelnovo di Sotto",999,4250,4377,8627
"1691",35016,"Castelnovo ne' Monti",999,5079,5269,10348
"1692",22049,"Castelnuovo",999,534,552,1086
"1693",5029,"Castelnuovo Belbo",999,395,429,824
"1694",52006,"Castelnuovo Berardenga",999,4391,4570,8961
"1695",98013,"Castelnuovo Bocca d'Adda",999,768,766,1534
"1696",6052,"Castelnuovo Bormida",999,294,322,616
"1697",13059,"Castelnuovo Bozzente",999,452,463,915
"1698",5030,"Castelnuovo Calcea",999,364,327,691
"1699",65032,"Castelnuovo Cilento",999,1362,1465,2827
"1700",23022,"Castelnuovo del Garda",999,6514,6730,13244
"1701",71017,"Castelnuovo della Daunia",999,645,642,1287
"1702",4054,"Castelnuovo di Ceva",999,51,52,103
"1703",65033,"Castelnuovo di Conza",999,260,246,506
"1704",57014,"Castelnuovo di Farfa",999,505,491,996
"1705",46009,"Castelnuovo di Garfagnana",999,2710,2899,5609
"1706",58024,"Castelnuovo di Porto",999,4253,4369,8622
"1707",50011,"Castelnuovo di Val di Cecina",999,1033,1050,2083
"1708",5031,"Castelnuovo Don Bosco",999,1516,1587,3103
"1709",11011,"Castelnuovo Magra",999,4023,4237,8260
"1710",1067,"Castelnuovo Nigra",999,211,187,398
"1711",60021,"Castelnuovo Parano",999,418,427,845
"1712",36007,"Castelnuovo Rangone",999,7534,7523,15057
"1713",6053,"Castelnuovo Scrivia",999,2361,2486,4847
"1714",62017,"Castelpagano",999,664,664,1328
"1715",94010,"Castelpetroso",999,782,741,1523
"1716",94011,"Castelpizzuto",999,72,57,129
"1717",42012,"Castelplanio",999,1791,1774,3565
"1718",62018,"Castelpoto",999,546,601,1147
"1719",43009,"Castelraimondo",999,2128,2251,4379
"1720",54008,"Castel Ritaldi",999,1506,1541,3047
"1721",5032,"Castel Rocchero",999,195,172,367
"1722",21019,"Castelrotto/Kastelruth",999,3556,3440,6996
"1723",16063,"Castel Rozzone",999,1364,1423,2787
"1724",65034,"Castel San Giorgio",999,6842,6896,13738
"1725",33013,"Castel San Giovanni",999,7085,7134,14219
"1726",65035,"Castel San Lorenzo",999,1079,1127,2206
"1727",51010,"Castel San Niccolò",999,1211,1239,2450
"1728",58025,"Castel San Pietro Romano",999,405,443,848
"1729",37020,"Castel San Pietro Terme",999,10152,10561,20713
"1730",57015,"Castel Sant'Angelo",999,613,574,1187
"1731",43010,"Castelsantangelo sul Nera",999,120,101,221
"1732",56017,"Castel Sant'Elia",999,1196,1233,2429
"1733",94012,"Castel San Vincenzo",999,224,209,433
"1734",76025,"Castelsaraceno",999,556,594,1150
"1735",90023,"Castelsardo",999,2792,2825,5617
"1736",12044,"Castelseprio",999,658,673,1331
"1737",101005,"Castelsilano",999,442,446,888
"1738",6054,"Castelspina",999,195,190,385
"1739",84012,"Casteltermini",999,3503,3709,7212
"1740",12045,"Castelveccana",999,909,924,1833
"1741",66030,"Castelvecchio Calvisio",999,55,65,120
"1742",9021,"Castelvecchio di Rocca Barbena",999,69,58,127
"1743",66031,"Castelvecchio Subequo",999,390,429,819
"1744",62019,"Castelvenere",999,1140,1249,2389
"1745",19026,"Castelverde",999,2815,2808,5623
"1746",94013,"Castelverrino",999,55,38,93
"1747",62020,"Castelvetere in Val Fortore",999,462,499,961
"1748",64024,"Castelvetere sul Calore",999,747,734,1481
"1749",81006,"Castelvetrano",999,14307,14942,29249
"1750",36008,"Castelvetro di Modena",999,5607,5454,11061
"1751",33014,"Castelvetro Piacentino",999,2677,2678,5355
"1752",55010,"Castel Viscardo",999,1296,1351,2647
"1753",19027,"Castelvisconti",999,164,150,314
"1754",8015,"Castel Vittorio",999,128,121,249
"1755",61027,"Castel Volturno",999,15329,14137,29466
"1756",37021,"Castenaso",999,7886,8496,16382
"1757",17043,"Castenedolo",999,5831,5880,11711
"1758",111011,"Castiadas",999,879,831,1710
"1759",68009,"Castiglione a Casauria",999,352,355,707
"1760",10013,"Castiglione Chiavarese",999,770,800,1570
"1761",78030,"Castiglione Cosentino",999,1421,1274,2695
"1762",98014,"Castiglione d'Adda",999,2239,2269,4508
"1763",37022,"Castiglione dei Pepoli",999,2768,2689,5457
"1764",65036,"Castiglione del Genovesi",999,669,613,1282
"1765",54009,"Castiglione del Lago",999,7388,7746,15134
"1766",53006,"Castiglione della Pescaia",999,3544,3608,7152
"1767",20017,"Castiglione delle Stiviere",999,11930,11925,23855
"1768",46010,"Castiglione di Garfagnana",999,865,853,1718
"1769",87014,"Castiglione di Sicilia",999,1419,1467,2886
"1770",52007,"Castiglione d'Orcia",999,1037,1088,2125
"1771",4055,"Castiglione Falletto",999,333,321,654
"1772",56018,"Castiglione in Teverina",999,1136,1164,2300
"1773",69020,"Castiglione Messer Marino",999,711,765,1476
"1774",67013,"Castiglione Messer Raimondo",999,1016,978,1994
"1775",12046,"Castiglione Olona",999,3714,3739,7453
"1776",4056,"Castiglione Tinella",999,385,372,757
"1777",1068,"Castiglione Torinese",999,3237,3280,6517
"1778",51011,"Castiglion Fibocchi",999,1087,1041,2128
"1779",51012,"Castiglion Fiorentino",999,6409,6510,12919
"1780",44012,"Castignano",999,1269,1272,2541
"1781",67014,"Castilenti",999,680,631,1311
"1782",4057,"Castino",999,233,208,441
"1783",14015,"Castione Andevenno",999,802,772,1574
"1784",16064,"Castione della Presolana",999,1647,1636,3283
"1785",30020,"Castions di Strada",999,1799,1868,3667
"1786",98015,"Castiraga Vidardo",999,1547,1513,3060
"1787",17044,"Casto",999,848,778,1626
"1788",44013,"Castorano",999,1098,1134,2232
"1789",17045,"Castrezzato",999,3883,3833,7716
"1790",75017,"Castri di Lecce",999,1341,1387,2728
"1791",75018,"Castrignano de' Greci",999,1759,1870,3629
"1792",75019,"Castrignano del Capo",999,2434,2643,5077
"1793",16065,"Castro",999,595,616,1211
"1794",75096,"Castro",999,1121,1231,2352
"1795",40005,"Castrocaro Terme e Terra del Sole",999,3156,3319,6475
"1796",60022,"Castrocielo",999,1831,1949,3780
"1797",60023,"Castro dei Volsci",999,2151,2272,4423
"1798",84013,"Castrofilippo",999,1239,1354,2593
"1799",78031,"Castrolibero",999,4377,4796,9173
"1800",12047,"Castronno",999,2527,2492,5019
"1801",82025,"Castronovo di Sicilia",999,1328,1458,2786
"1802",76026,"Castronuovo di Sant'Andrea",999,406,456,862
"1803",70016,"Castropignano",999,417,451,868
"1804",83016,"Castroreale",999,1117,1147,2264
"1805",78032,"Castroregio",999,133,88,221
"1806",78033,"Castrovillari",999,9930,10713,20643
"1807",87015,"Catania",999,143581,154628,298209
"1808",79023,"Catanzaro",999,40114,44001,84115
"1809",86006,"Catenanuova",999,2203,2249,4452
"1810",68010,"Catignano",999,615,608,1223
"1811",99002,"Cattolica",999,7814,8806,16620
"1812",84014,"Cattolica Eraclea",999,1607,1642,3249
"1813",80025,"Caulonia",999,3304,3419,6723
"1814",62021,"Cautano",999,963,934,1897
"1815",65037,"Cava de' Tirreni",999,24293,25898,50191
"1816",96016,"Cavaglià",999,1787,1732,3519
"1817",3044,"Cavaglietto",999,197,188,385
"1818",3045,"Cavaglio d'Agogna",999,559,577,1136
"1819",1069,"Cavagnolo",999,1129,1185,2314
"1820",23023,"Cavaion Veronese",999,2998,3110,6108
"1821",22050,"Cavalese",999,1935,2052,3987
"1822",4058,"Cavallerleone",999,347,327,674
"1823",4059,"Cavallermaggiore",999,2681,2660,5341
"1824",75020,"Cavallino",999,6281,6632,12913
"1825",27044,"Cavallino-Treporti",999,6450,6796,13246
"1826",3047,"Cavallirio",999,639,637,1276
"1827",18041,"Cava Manara",999,3233,3435,6668
"1828",22051,"Cavareno",999,577,546,1123
"1829",13062,"Cavargna",999,92,78,170
"1830",12048,"Cavaria con Premezzo",999,2856,2842,5698
"1831",27006,"Cavarzere",999,6052,6220,12272
"1832",26014,"Cavaso del Tomba",999,1451,1479,2930
"1833",93012,"Cavasso Nuovo",999,743,755,1498
"1834",6055,"Cavatore",999,116,142,258
"1835",30021,"Cavazzo Carnico",999,466,489,955
"1836",58026,"Cave",999,5396,5426,10822
"1837",22052,"Cavedago",999,303,273,576
"1838",22053,"Cavedine",999,1540,1533,3073
"1839",98017,"Cavenago d'Adda",999,1048,1077,2125
"1840",108017,"Cavenago di Brianza",999,3713,3774,7487
"1841",16066,"Cavernago",999,1452,1416,2868
"1842",36009,"Cavezzo",999,3485,3676,7161
"1843",22054,"Cavizzana",999,111,123,234
"1844",1070,"Cavour",999,2698,2724,5422
"1845",35017,"Cavriago",999,4817,5085,9902
"1846",20018,"Cavriana",999,1827,1895,3722
"1847",51013,"Cavriglia",999,4744,4745,9489
"1848",12049,"Cazzago Brabbia",999,391,395,786
"1849",17046,"Cazzago San Martino",999,5353,5426,10779
"1850",23024,"Cazzano di Tramigna",999,733,753,1486
"1851",16067,"Cazzano Sant'Andrea",999,861,825,1686
"1852",60024,"Ceccano",999,10839,11376,22215
"1853",18042,"Cecima",999,127,120,247
"1854",49007,"Cecina",999,13382,14682,28064
"1855",17047,"Cedegolo",999,550,555,1105
"1856",14016,"Cedrasco",999,199,219,418
"1857",82026,"Cefalà Diana",999,487,489,976
"1858",82027,"Cefalù",999,6704,7157,13861
"1859",27007,"Ceggia",999,3080,3084,6164
"1860",74003,"Ceglie Messapica",999,8923,9693,18616
"1861",66032,"Celano",999,5191,5018,10209
"1862",69021,"Celenza sul Trigno",999,384,398,782
"1863",71018,"Celenza Valfortore",999,640,704,1344
"1864",78034,"Celico",999,1282,1232,2514
"1865",19028,"Cella Dati",999,239,239,478
"1866",72018,"Cellamare",999,2860,2942,5802
"1867",6056,"Cella Monte",999,231,224,455
"1868",78035,"Cellara",999,243,236,479
"1869",5033,"Cellarengo",999,364,348,712
"1870",17048,"Cellatica",999,2323,2514,4837
"1871",65038,"Celle di Bulgheria",999,824,887,1711
"1872",4060,"Celle di Macra",999,50,39,89
"1873",71019,"Celle di San Vito",999,76,72,148
"1874",5034,"Celle Enomondo",999,206,223,429
"1875",9022,"Celle Ligure",999,2327,2505,4832
"1876",56019,"Celleno",999,632,675,1307
"1877",56020,"Cellere",999,569,511,1080
"1878",67015,"Cellino Attanasio",999,1096,1110,2206
"1879",74004,"Cellino San Marco",999,2851,3153,6004
"1880",2171,"Cellio con Breia",999,464,472,936
"1881",61102,"Cellole",999,3972,4266,8238
"1882",22241,"Cembra Lisignago",999,1202,1144,2346
"1883",79024,"Cenadi",999,248,266,514
"1884",16068,"Cenate Sopra",999,1274,1253,2527
"1885",16069,"Cenate Sotto",999,1974,1945,3919
"1886",25010,"Cencenighe Agordino",999,609,608,1217
"1887",16070,"Cene",999,2027,2035,4062
"1888",29014,"Ceneselli",999,782,772,1554
"1889",9023,"Cengio",999,1640,1668,3308
"1890",4061,"Centallo",999,3612,3334,6946
"1891",38004,"Cento",999,17518,17896,35414
"1892",65039,"Centola",999,2537,2421,4958
"1893",79025,"Centrache",999,175,176,351
"1894",13254,"Centro Valle Intelvi",999,1853,1897,3750
"1895",86007,"Centuripe",999,2481,2535,5016
"1896",68011,"Cepagatti",999,5397,5572,10969
"1897",62022,"Ceppaloni",999,1593,1584,3177
"1898",103021,"Ceppo Morelli",999,158,134,292
"1899",60025,"Ceprano",999,3972,4059,8031
"1900",86008,"Cerami",999,901,949,1850
"1901",10014,"Ceranesi",999,1829,1766,3595
"1902",3049,"Cerano",999,3327,3430,6757
"1903",13063,"Cerano d'Intelvi",999,281,311,592
"1904",18043,"Ceranova",999,1165,1145,2310
"1905",65040,"Ceraso",999,1098,1125,2223
"1906",70017,"Cercemaggiore",999,1840,1772,3612
"1907",1071,"Cercenasco",999,857,905,1762
"1908",70018,"Cercepiccola",999,305,334,639
"1909",78036,"Cerchiara di Calabria",999,1074,1057,2131
"1910",66033,"Cerchio",999,768,767,1535
"1911",14017,"Cercino",999,408,389,797
"1912",30022,"Cercivento",999,323,317,640
"1913",63026,"Cercola",999,8147,8735,16882
"1914",82028,"Cerda",999,2394,2487,4881
"1915",23025,"Cerea",999,8356,8559,16915
"1916",29015,"Ceregnano",999,1642,1745,3387
"1917",101006,"Cerenzia",999,517,508,1025
"1918",1072,"Ceres",999,525,476,1001
"1919",20019,"Ceresara",999,1276,1235,2511
"1920",6057,"Cereseto",999,191,181,372
"1921",4062,"Ceresole Alba",999,1001,996,1997
"1922",1073,"Ceresole Reale",999,83,70,153
"1923",16071,"Cerete",999,818,827,1645
"1924",18044,"Ceretto Lomellina",999,92,99,191
"1925",18045,"Cergnago",999,338,333,671
"1926",9024,"Ceriale",999,2611,2715,5326
"1927",8016,"Ceriana",999,564,511,1075
"1928",108018,"Ceriano Laghetto",999,3276,3382,6658
"1929",33015,"Cerignale",999,67,56,123
"1930",71020,"Cerignola",999,28360,28660,57020
"1931",78037,"Cerisano",999,1444,1464,2908
"1932",13064,"Cermenate",999,4673,4738,9411
"1933",21020,"Cermes/Tscherms",999,768,771,1539
"1934",67016,"Cermignano",999,708,737,1445
"1935",13065,"Cernobbio",999,3040,3291,6331
"1936",97020,"Cernusco Lombardone",999,1877,1974,3851
"1937",15070,"Cernusco sul Naviglio",999,16796,18102,34898
"1938",5035,"Cerreto d'Asti",999,109,102,211
"1939",42013,"Cerreto d'Esi",999,1710,1691,3401
"1940",54010,"Cerreto di Spoleto",999,482,489,971
"1941",6058,"Cerreto Grue",999,141,154,295
"1942",48011,"Cerreto Guidi",999,5248,5497,10745
"1943",58027,"Cerreto Laziale",999,532,541,1073
"1944",62023,"Cerreto Sannita",999,1762,1823,3585
"1945",4063,"Cerretto Langhe",999,202,186,388
"1946",6059,"Cerrina Monferrato",999,634,654,1288
"1947",96018,"Cerrione",999,1344,1413,2757
"1948",15071,"Cerro al Lambro",999,2549,2637,5186
"1949",94014,"Cerro al Volturno",999,583,540,1123
"1950",15072,"Cerro Maggiore",999,7381,7650,15031
"1951",5036,"Cerro Tanaro",999,303,288,591
"1952",23026,"Cerro Veronese",999,1369,1312,2681
"1953",76027,"Cersosimo",999,250,263,513
"1954",48012,"Certaldo",999,7742,7893,15635
"1955",18046,"Certosa di Pavia",999,2792,2735,5527
"1956",79027,"Cerva",999,485,562,1047
"1957",58028,"Cervara di Roma",999,256,205,461
"1958",28030,"Cervarese Santa Croce",999,2780,2798,5578
"1959",60026,"Cervaro",999,3802,3983,7785
"1960",4064,"Cervasca",999,2620,2558,5178
"1961",2041,"Cervatto",999,29,18,47
"1962",17049,"Cerveno",999,364,331,695
"1963",4065,"Cervere",999,1133,1128,2261
"1964",18047,"Cervesina",999,509,609,1118
"1965",58029,"Cerveteri",999,18733,19217,37950
"1966",39007,"Cervia",999,13942,14882,28824
"1967",78038,"Cervicati",999,390,395,785
"1968",98018,"Cervignano d'Adda",999,1112,1128,2240
"1969",30023,"Cervignano del Friuli",999,6769,6897,13666
"1970",64025,"Cervinara",999,4205,4420,8625
"1971",61028,"Cervino",999,2308,2409,4717
"1972",8017,"Cervo",999,513,562,1075
"1973",78039,"Cerzeto",999,601,598,1199
"1974",61029,"Cesa",999,4820,4823,9643
"1975",97021,"Cesana Brianza",999,1157,1186,2343
"1976",1074,"Cesana Torinese",999,493,400,893
"1977",15074,"Cesano Boscone",999,11360,12035,23395
"1978",108019,"Cesano Maderno",999,19736,19813,39549
"1979",103022,"Cesara",999,326,285,611
"1980",83017,"Cesarò",999,1045,1069,2114
"1981",15076,"Cesate",999,6995,7314,14309
"1982",40007,"Cesena",999,46674,49471,96145
"1983",40008,"Cesenatico",999,12631,13314,25945
"1984",64026,"Cesinali",999,1268,1286,2554
"1985",8018,"Cesio",999,142,116,258
"1986",25011,"Cesiomaggiore",999,2008,1933,3941
"1987",26015,"Cessalto",999,1903,1889,3792
"1988",102006,"Cessaniti",999,1476,1466,2942
"1989",43011,"Cessapalombo",999,205,231,436
"1990",5037,"Cessole",999,168,173,341
"1991",65041,"Cetara",999,964,973,1937
"1992",17050,"Ceto",999,879,890,1769
"1993",52008,"Cetona",999,1186,1306,2492
"1994",78040,"Cetraro",999,4638,4740,9378
"1995",4066,"Ceva",999,2944,2908,5852
"1996",17051,"Cevo",999,417,384,801
"1997",7013,"Challand-Saint-Anselme",999,379,362,741
"1998",7014,"Challand-Saint-Victor",999,272,272,544
"1999",7015,"Chambave",999,433,436,869
"2000",7016,"Chamois",999,59,49,108
"2001",7017,"Champdepraz",999,343,383,726
"2002",7018,"Champorcher",999,189,178,367
"2003",7019,"Charvensod",999,1180,1241,2421
"2004",7020,"Châtillon",999,2151,2215,4366
"2005",4067,"Cherasco",999,4765,4787,9552
"2006",90024,"Cheremule",999,197,196,393
"2007",1075,"Chialamberto",999,159,176,335
"2008",24029,"Chiampo",999,6400,6140,12540
"2009",64027,"Chianche",999,246,219,465
"2010",52009,"Chianciano Terme",999,3500,3489,6989
"2011",50012,"Chianni",999,671,647,1318
"2012",1076,"Chianocco",999,755,760,1515
"2013",88002,"Chiaramonte Gulfi",999,4149,3870,8019
"2014",90025,"Chiaramonti",999,740,784,1524
"2015",26016,"Chiarano",999,1846,1738,3584
"2016",42014,"Chiaravalle",999,6803,7479,14282
"2017",79029,"Chiaravalle Centrale",999,2407,2681,5088
"2018",17052,"Chiari",999,9588,9760,19348
"2019",76028,"Chiaromonte",999,832,878,1710
"2020",94015,"Chiauci",999,102,96,198
"2021",10015,"Chiavari",999,12713,14742,27455
"2022",14018,"Chiavenna",999,3451,3806,7257
"2023",1077,"Chiaverano",999,959,1011,1970
"2024",21021,"Chienes/Kiens",999,1547,1493,3040
"2025",1078,"Chieri",999,17388,18559,35947
"2026",14019,"Chiesa in Valmalenco",999,1122,1159,2281
"2027",1079,"Chiesanuova",999,116,110,226
"2028",25012,"Chies d'Alpago",999,626,615,1241
"2029",47022,"Chiesina Uzzanese",999,2204,2284,4488
"2030",69022,"Chieti",999,23237,25348,48585
"2031",71021,"Chieuti",999,741,753,1494
"2032",19029,"Chieve",999,1130,1150,2280
"2033",16072,"Chignolo d'Isola",999,1768,1634,3402
"2034",18048,"Chignolo Po",999,2021,1987,4008
"2035",27008,"Chioggia",999,23621,23949,47570
"2036",1080,"Chiomonte",999,422,435,857
"2037",93013,"Chions",999,2506,2541,5047
"2038",30024,"Chiopris-Viscone",999,339,364,703
"2039",51014,"Chitignano",999,426,413,839
"2040",16073,"Chiuduno",999,3129,3054,6183
"2041",24030,"Chiuppano",999,1269,1251,2520
"2042",14020,"Chiuro",999,1181,1261,2442
"2043",4068,"Chiusa di Pesio",999,1866,1814,3680
"2044",1081,"Chiusa di San Michele",999,770,744,1514
"2045",30025,"Chiusaforte",999,313,280,593
"2046",21022,"Chiusa/Klausen",999,2626,2570,5196
"2047",8019,"Chiusanico",999,326,277,603
"2048",5038,"Chiusano d'Asti",999,133,124,257
"2049",64028,"Chiusano di San Domenico",999,1016,1046,2062
"2050",82029,"Chiusa Sclafani",999,1158,1314,2472
"2051",8020,"Chiusavecchia",999,255,255,510
"2052",52010,"Chiusdino",999,843,870,1713
"2053",52011,"Chiusi",999,4082,4094,8176
"2054",51015,"Chiusi della Verna",999,923,938,1861
"2055",1082,"Chivasso",999,12700,13501,26201
"2056",58118,"Ciampino",999,18502,20272,38774
"2057",84015,"Cianciana",999,1436,1604,3040
"2058",25013,"Cibiana di Cadore",999,153,168,321
"2059",10016,"Cicagna",999,1154,1095,2249
"2060",79030,"Cicala",999,423,431,854
"2061",63027,"Cicciano",999,6053,6285,12338
"2062",65042,"Cicerale",999,576,604,1180
"2063",58030,"Ciciliano",999,628,622,1250
"2064",19030,"Cicognolo",999,456,465,921
"2065",1083,"Ciconio",999,187,181,368
"2066",2042,"Cigliano",999,2084,2172,4256
"2067",4069,"Cigliè",999,99,91,190
"2068",18049,"Cigognola",999,628,669,1297
"2069",17053,"Cigole",999,750,737,1487
"2070",18050,"Cilavegna",999,2635,2705,5340
"2071",26017,"Cimadolmo",999,1693,1681,3374
"2072",17054,"Cimbergo",999,277,256,533
"2073",80026,"Ciminà",999,269,254,523
"2074",82030,"Ciminna",999,1620,1733,3353
"2075",63028,"Cimitile",999,3324,3556,6880
"2076",93014,"Cimolais",999,180,170,350
"2077",22058,"Cimone",999,374,355,729
"2078",5039,"Cinaglio",999,208,200,408
"2079",58031,"Cineto Romano",999,284,305,589
"2080",19031,"Cingia de' Botti",999,570,556,1126
"2081",43012,"Cingoli",999,4654,4921,9575
"2082",53007,"Cinigiano",999,1288,1144,2432
"2083",15077,"Cinisello Balsamo",999,36965,37981,74946
"2084",82031,"Cinisi",999,5859,6063,11922
"2085",14021,"Cino",999,179,171,350
"2086",80027,"Cinquefrondi",999,3009,3213,6222
"2087",1084,"Cintano",999,129,117,246
"2088",22059,"Cinte Tesino",999,175,182,357
"2089",27009,"Cinto Caomaggiore",999,1576,1625,3201
"2090",28031,"Cinto Euganeo",999,967,938,1905
"2091",1085,"Cinzano",999,176,164,340
"2092",61030,"Ciorlano",999,183,179,362
"2093",8021,"Cipressa",999,587,606,1193
"2094",62024,"Circello",999,1056,1082,2138
"2095",1086,"Ciriè",999,8709,9415,18124
"2096",77005,"Cirigliano",999,125,150,275
"2097",13068,"Cirimido",999,1097,1068,2165
"2098",101007,"Cirò",999,1162,1267,2429
"2099",101008,"Cirò Marina",999,6873,7270,14143
"2100",22060,"Cis",999,140,152,292
"2101",16074,"Cisano Bergamasco",999,3080,3138,6218
"2102",9025,"Cisano sul Neva",999,1053,1070,2123
"2103",16075,"Ciserano",999,2922,2756,5678
"2104",12050,"Cislago",999,5181,5239,10420
"2105",15078,"Cisliano",999,2534,2585,5119
"2106",26018,"Cison di Valmarino",999,1167,1219,2386
"2107",4070,"Cissone",999,49,30,79
"2108",5040,"Cisterna d'Asti",999,619,577,1196
"2109",59005,"Cisterna di Latina",999,17980,18188,36168
"2110",74005,"Cisternino",999,5314,5769,11083
"2111",54011,"Citerna",999,1703,1669,3372
"2112",28032,"Cittadella",999,9779,10279,20058
"2113",54012,"Città della Pieve",999,3553,3854,7407
"2114",54013,"Città di Castello",999,18395,19800,38195
"2115",57016,"Cittaducale",999,3169,3242,6411
"2116",80028,"Cittanova",999,4713,4963,9676
"2117",57017,"Cittareale",999,210,185,395
"2118",68012,"Città Sant'Angelo",999,7385,7487,14872
"2119",12051,"Cittiglio",999,1866,1958,3824
"2120",97022,"Civate",999,1851,1855,3706
"2121",8022,"Civezza",999,309,316,625
"2122",22061,"Civezzano",999,2122,2089,4211
"2123",2043,"Civiasco",999,113,110,223
"2124",30026,"Cividale del Friuli",999,5149,5623,10772
"2125",16076,"Cividate al Piano",999,2578,2457,5035
"2126",17055,"Cividate Camuno",999,1376,1301,2677
"2127",78041,"Civita",999,384,424,808
"2128",70019,"Civitacampomarano",999,129,162,291
"2129",56021,"Civita Castellana",999,7360,7815,15175
"2130",66034,"Civita d'Antino",999,486,461,947
"2131",69023,"Civitaluparella",999,143,140,283
"2132",94016,"Civitanova del Sannio",999,446,431,877
"2133",43013,"Civitanova Marche",999,20085,21915,42000
"2134",68013,"Civitaquana",999,566,544,1110
"2135",58032,"Civitavecchia",999,24908,26842,51750
"2136",66035,"Civitella Alfedena",999,152,142,294
"2137",68014,"Civitella Casanova",999,784,792,1576
"2138",56022,"Civitella d'Agliano",999,722,728,1450
"2139",67017,"Civitella del Tronto",999,2285,2278,4563
"2140",40009,"Civitella di Romagna",999,1821,1823,3644
"2141",51016,"Civitella in Val di Chiana",999,4337,4396,8733
"2142",69024,"Civitella Messer Raimondo",999,378,391,769
"2143",53008,"Civitella Paganico",999,1458,1456,2914
"2144",66036,"Civitella Roveto",999,1533,1467,3000
"2145",58033,"Civitella San Paolo",999,997,1001,1998
"2146",14022,"Civo",999,571,537,1108
"2147",13071,"Claino con Osteno",999,287,257,544
"2148",93015,"Claut",999,426,447,873
"2149",93016,"Clauzetto",999,202,171,373
"2150",4071,"Clavesana",999,388,405,793
"2151",1087,"Claviere",999,104,107,211
"2152",22062,"Cles",999,3538,3771,7309
"2153",78042,"Cleto",999,650,581,1231
"2154",12052,"Clivio",999,969,1019,1988
"2155",16077,"Clusone",999,4172,4457,8629
"2156",1088,"Coassolo Torinese",999,744,721,1465
"2157",1089,"Coazze",999,1644,1625,3269
"2158",5041,"Coazzolo",999,152,150,302
"2159",17056,"Coccaglio",999,4447,4408,8855
"2160",5042,"Cocconato",999,731,706,1437
"2161",12053,"Cocquio-Trevisago",999,2219,2412,4631
"2162",66037,"Cocullo",999,109,102,211
"2163",28033,"Codevigo",999,3201,3049,6250
"2164",18051,"Codevilla",999,436,484,920
"2165",38005,"Codigoro",999,5303,5738,11041
"2166",26019,"Codognè",999,2694,2535,5229
"2167",98019,"Codogno",999,7583,8091,15674
"2168",30027,"Codroipo",999,7842,8064,15906
"2169",90026,"Codrongianos",999,623,638,1261
"2170",96019,"Coggiola",999,799,835,1634
"2171",108020,"Cogliate",999,4170,4337,8507
"2172",7021,"Cogne",999,647,666,1313
"2173",10017,"Cogoleto",999,4062,4350,8412
"2174",24032,"Cogollo del Cengio",999,1546,1568,3114
"2175",10018,"Cogorno",999,2826,2897,5723
"2176",3051,"Colazza",999,292,252,544
"2177",24126,"Colceresa",999,2936,2976,5912
"2178",16078,"Colere",999,561,534,1095
"2179",60027,"Colfelice",999,872,910,1782
"2180",33016,"Coli",999,432,411,843
"2181",97023,"Colico",999,4087,4083,8170
"2182",57018,"Collalto Sabino",999,210,172,382
"2183",66038,"Collarmele",999,365,417,782
"2184",54014,"Collazzone",999,1598,1704,3302
"2185",17057,"Collebeato",999,2141,2293,4434
"2186",97024,"Colle Brianza",999,933,888,1821
"2187",34009,"Collecchio",999,7333,7461,14794
"2188",68015,"Collecorvino",999,2988,2979,5967
"2189",70020,"Colle d'Anchise",999,365,372,737
"2190",67018,"Colledara",999,1040,1035,2075
"2191",69025,"Colledimacine",999,92,61,153
"2192",69026,"Colledimezzo",999,223,214,437
"2193",57019,"Colle di Tora",999,197,174,371
"2194",52012,"Colle di Val d'Elsa",999,10534,11087,21621
"2195",58034,"Colleferro",999,9912,10575,20487
"2196",57020,"Collegiove",999,70,53,123
"2197",1090,"Collegno",999,23077,25084,48161
"2198",66039,"Collelongo",999,550,523,1073
"2199",60028,"Collepardo",999,447,436,883
"2200",75021,"Collepasso",999,2690,2864,5554
"2201",66040,"Collepietro",999,95,104,199
"2202",1091,"Colleretto Castelnuovo",999,173,164,337
"2203",1092,"Colleretto Giacosa",999,293,288,581
"2204",49008,"Collesalvetti",999,8050,8357,16407
"2205",60029,"Colle San Magno",999,314,302,616
"2206",62025,"Colle Sannita",999,1040,1108,2148
"2207",82032,"Collesano",999,1742,1874,3616
"2208",25014,"Colle Santa Lucia",999,175,170,345
"2209",70021,"Colletorto",999,807,836,1643
"2210",26020,"Colle Umberto",999,2481,2554,5035
"2211",57021,"Collevecchio",999,818,775,1593
"2212",41069,"Colli al Metauro",999,6213,6152,12365
"2213",65043,"Colliano",999,1660,1743,3403
"2214",94017,"Colli a Volturno",999,630,633,1263
"2215",44014,"Colli del Tronto",999,1810,1822,3632
"2216",111012,"Collinas",999,362,390,752
"2217",17058,"Collio",999,1013,970,1983
"2218",57022,"Colli sul Velino",999,218,237,455
"2219",18193,"Colli Verdi",999,531,490,1021
"2220",2045,"Collobiano",999,36,38,74
"2221",30028,"Colloredo di Monte Albano",999,1071,1106,2177
"2222",43014,"Colmurano",999,565,589,1154
"2223",77006,"Colobraro",999,527,523,1050
"2224",23027,"Cologna Veneta",999,4216,4218,8434
"2225",17059,"Cologne",999,3809,3818,7627
"2226",16079,"Cologno al Serio",999,5618,5506,11124
"2227",23028,"Colognola ai Colli",999,4365,4385,8750
"2228",15081,"Cologno Monzese",999,22813,24230,47043
"2229",58035,"Colonna",999,2065,2183,4248
"2230",67019,"Colonnella",999,1861,1805,3666
"2231",13074,"Colonno",999,221,213,434
"2232",14023,"Colorina",999,663,657,1320
"2233",34010,"Colorno",999,4555,4536,9091
"2234",78043,"Colosimi",999,542,566,1108
"2235",15082,"Colturano",999,1029,1016,2045
"2236",13251,"Colverde",999,2712,2809,5521
"2237",16080,"Colzate",999,793,826,1619
"2238",12054,"Comabbio",999,607,572,1179
"2239",38006,"Comacchio",999,10889,11148,22037
"2240",45005,"Comano",999,335,330,665
"2241",22228,"Comano Terme",999,1463,1485,2948
"2242",98020,"Comazzo",999,1217,1124,2341
"2243",30029,"Comeglians",999,221,205,426
"2244",25015,"Comelico Superiore",999,1010,1050,2060
"2245",12055,"Comerio",999,1351,1467,2818
"2246",17060,"Comezzano-Cizzago",999,2127,2019,4146
"2247",3052,"Comignago",999,665,597,1262
"2248",88003,"Comiso",999,14947,15145,30092
"2249",84016,"Comitini",999,419,427,846
"2250",63029,"Comiziano",999,836,869,1705
"2251",20020,"Commessaggio",999,515,536,1051
"2252",22064,"Commezzadura",999,502,512,1014
"2253",13075,"Como",999,40711,43088,83799
"2254",34011,"Compiano",999,536,512,1048
"2255",44015,"Comunanza",999,1473,1429,2902
"2256",16081,"Comun Nuovo",999,2260,2174,4434
"2257",27010,"Cona",999,1326,1406,2732
"2258",94018,"Conca Casale",999,88,77,165
"2259",65044,"Conca dei Marini",999,337,311,648
"2260",61031,"Conca della Campania",999,569,580,1149
"2261",23029,"Concamarise",999,553,516,1069
"2262",57023,"Concerviano",999,138,140,278
"2263",17061,"Concesio",999,7748,7936,15684
"2264",27011,"Concordia Sagittaria",999,4992,5263,10255
"2265",36010,"Concordia sulla Secchia",999,4121,4211,8332
"2266",108021,"Concorezzo",999,7814,8159,15973
"2267",80029,"Condofuri",999,2210,2342,4552
"2268",1093,"Condove",999,2172,2283,4455
"2269",83018,"Condrò",999,235,244,479
"2270",26021,"Conegliano",999,16614,17831,34445
"2271",18052,"Confienza",999,780,784,1564
"2272",57024,"Configni",999,303,271,574
"2273",79033,"Conflenti",999,658,664,1322
"2274",6060,"Coniolo",999,223,210,433
"2275",39008,"Conselice",999,4758,4865,9623
"2276",28034,"Conselve",999,4867,5153,10020
"2277",22242,"Contà",999,692,717,1409
"2278",82033,"Contessa Entellina",999,721,751,1472
"2279",57025,"Contigliano",999,1850,1823,3673
"2280",64029,"Contrada",999,1481,1436,2917
"2281",67020,"Controguerra",999,1092,1127,2219
"2282",65045,"Controne",999,386,378,764
"2283",65046,"Contursi Terme",999,1571,1596,3167
"2284",72019,"Conversano",999,12664,13144,25808
"2285",64030,"Conza della Campania",999,632,640,1272
"2286",6061,"Conzano",999,471,461,932
"2287",75022,"Copertino",999,11181,11768,22949
"2288",18053,"Copiano",999,870,855,1725
"2289",38007,"Copparo",999,7521,8196,15717
"2290",18054,"Corana",999,374,378,752
"2291",72020,"Corato",999,23001,23993,46994
"2292",65047,"Corbara",999,1220,1264,2484
"2293",15085,"Corbetta",999,9342,9592,18934
"2294",29017,"Corbola",999,1058,1166,2224
"2295",56023,"Corchiano",999,1807,1763,3570
"2296",54015,"Corciano",999,10498,11099,21597
"2297",93017,"Cordenons",999,8742,9087,17829
"2298",26022,"Cordignano",999,3382,3488,6870
"2299",93018,"Cordovado",999,1348,1389,2737
"2300",46011,"Coreglia Antelminelli",999,2509,2557,5066
"2301",10019,"Coreglia Ligure",999,136,119,255
"2302",60030,"Coreno Ausonio",999,752,765,1517
"2303",66041,"Corfinio",999,490,468,958
"2304",59006,"Cori",999,5234,5227,10461
"2305",99003,"Coriano",999,5223,5243,10466
"2306",75023,"Corigliano d'Otranto",999,2685,2924,5609
"2307",78157,"Corigliano-Rossano",999,36635,37456,74091
"2308",42015,"Corinaldo",999,2304,2441,4745
"2309",1094,"Corio",999,1525,1519,3044
"2310",82034,"Corleone",999,5087,5189,10276
"2311",65048,"Corleto Monforte",999,240,245,485
"2312",76029,"Corleto Perticara",999,1139,1145,2284
"2313",15086,"Cormano",999,9910,10676,20586
"2314",31002,"Cormons",999,3355,3780,7135
"2315",16082,"Corna Imagna",999,475,443,918
"2316",16249,"Cornalba",999,160,137,297
"2317",18191,"Cornale e Bastida",999,403,406,809
"2318",15087,"Cornaredo",999,10111,10561,20672
"2319",108053,"Cornate d'Adda",999,5494,5451,10945
"2320",21023,"Cornedo all'Isarco/Karneid",999,1718,1720,3438
"2321",24034,"Cornedo Vicentino",999,5920,5770,11690
"2322",98021,"Cornegliano Laudense",999,1375,1468,2843
"2323",4072,"Corneliano d'Alba",999,1042,1096,2138
"2324",34012,"Corniglio",999,913,835,1748
"2325",30030,"Corno di Rosazzo",999,1547,1596,3143
"2326",98022,"Corno Giovine",999,555,587,1142
"2327",98023,"Cornovecchio",999,104,93,197
"2328",26023,"Cornuda",999,2998,3070,6068
"2329",35020,"Correggio",999,12425,12741,25166
"2330",108022,"Correzzana",999,1601,1604,3205
"2331",28035,"Correzzola",999,2604,2527,5131
"2332",13077,"Corrido",999,420,428,848
"2333",43015,"Corridonia",999,7216,7487,14703
"2334",67021,"Corropoli",999,2501,2593,5094
"2335",75024,"Corsano",999,2519,2589,5108
"2336",15093,"Corsico",999,16705,17945,34650
"2337",5044,"Corsione",999,104,97,201
"2338",21024,"Cortaccia sulla strada del vino/Kurtatsch an der Weinstraße",999,1089,1134,2223
"2339",79034,"Cortale",999,871,958,1829
"2340",5045,"Cortandone",999,156,163,319
"2341",5046,"Cortanze",999,129,128,257
"2342",5047,"Cortazzone",999,308,286,594
"2343",33017,"Corte Brugnatella",999,265,253,518
"2344",19032,"Corte de' Cortesi con Cignone",999,550,507,1057
"2345",19033,"Corte de' Frati",999,680,653,1333
"2346",17062,"Corte Franca",999,3607,3571,7178
"2347",33018,"Cortemaggiore",999,2418,2244,4662
"2348",4073,"Cortemilia",999,1043,1109,2152
"2349",17063,"Corteno Golgi",999,967,947,1914
"2350",97025,"Cortenova",999,570,584,1154
"2351",16083,"Cortenuova",999,1002,987,1989
"2352",18192,"Corteolona e Genzone",999,1250,1297,2547
"2353",98024,"Corte Palasio",999,793,751,1544
"2354",5048,"Cortiglione",999,261,267,528
"2355",25016,"Cortina d'Ampezzo",999,2598,2919,5517
"2356",21025,"Cortina sulla strada del vino/Kurtinig an der Weinstraße",999,344,337,681
"2357",67022,"Cortino",999,309,263,572
"2358",51017,"Cortona",999,10183,10859,21042
"2359",68016,"Corvara",999,99,113,212
"2360",21026,"Corvara in Badia/Corvara",999,679,712,1391
"2361",18057,"Corvino San Quirico",999,476,488,964
"2362",17064,"Corzano",999,726,713,1439
"2363",30031,"Coseano",999,984,1030,2014
"2364",78045,"Cosenza",999,29972,33721,63693
"2365",8023,"Cosio d'Arroscia",999,80,94,174
"2366",14024,"Cosio Valtellino",999,2809,2752,5561
"2367",80030,"Cosoleto",999,368,382,750
"2368",4074,"Cossano Belbo",999,442,423,865
"2369",1095,"Cossano Canavese",999,215,211,426
"2370",96020,"Cossato",999,6623,7246,13869
"2371",9026,"Cosseria",999,509,526,1035
"2372",44016,"Cossignano",999,411,443,854
"2373",103023,"Cossogno",999,354,332,686
"2374",90027,"Cossoine",999,371,381,752
"2375",5049,"Cossombrato",999,249,257,506
"2376",24035,"Costabissara",999,3774,3831,7605
"2377",54016,"Costacciaro",999,508,532,1040
"2378",18058,"Costa de' Nobili",999,185,170,355
"2379",16084,"Costa di Mezzate",999,1742,1690,3432
"2380",29018,"Costa di Rovigo",999,1180,1275,2455
"2381",97026,"Costa Masnaga",999,2385,2381,4766
"2382",2047,"Costanzana",999,379,392,771
"2383",8024,"Costarainera",999,389,396,785
"2384",16247,"Costa Serina",999,465,429,894
"2385",16085,"Costa Valle Imagna",999,284,276,560
"2386",6062,"Costa Vescovato",999,171,141,312
"2387",16086,"Costa Volpino",999,4317,4468,8785
"2388",23030,"Costermano sul Garda",999,1996,1977,3973
"2389",5050,"Costigliole d'Asti",999,2842,2814,5656
"2390",4075,"Costigliole Saluzzo",999,1722,1600,3322
"2391",39009,"Cotignola",999,3617,3754,7371
"2392",101009,"Cotronei",999,2555,2640,5195
"2393",57026,"Cottanello",999,279,247,526
"2394",7022,"Courmayeur",999,1309,1299,2608
"2395",16087,"Covo",999,2240,2104,4344
"2396",18059,"Cozzo",999,187,157,344
"2397",77007,"Craco",999,298,294,592
"2398",97027,"Crandola Valsassina",999,136,128,264
"2399",2048,"Cravagliana",999,134,114,248
"2400",4076,"Cravanzana",999,173,178,351
"2401",103024,"Craveggia",999,451,371,822
"2402",24036,"Creazzo",999,5491,5716,11207
"2403",69027,"Crecchio",999,1301,1313,2614
"2404",16088,"Credaro",999,1792,1734,3526
"2405",19034,"Credera Rubbiano",999,764,768,1532
"2406",19035,"Crema",999,16377,17543,33920
"2407",97028,"Cremella",999,829,835,1664
"2408",12056,"Cremenaga",999,377,414,791
"2409",97029,"Cremeno",999,986,792,1778
"2410",13083,"Cremia",999,345,352,697
"2411",6063,"Cremolino",999,529,502,1031
"2412",19036,"Cremona",999,34563,36531,71094
"2413",19037,"Cremosano",999,889,833,1722
"2414",2049,"Crescentino",999,3863,3778,7641
"2415",24037,"Crespadoro",999,640,574,1214
"2416",98025,"Crespiatica",999,1121,1066,2187
"2417",50041,"Crespina Lorenzana",999,2694,2748,5442
"2418",29019,"Crespino",999,856,898,1754
"2419",3055,"Cressa",999,764,788,1552
"2420",96021,"Crevacuore",999,675,688,1363
"2421",37024,"Crevalcore",999,6935,7017,13952
"2422",103025,"Crevoladossola",999,2204,2288,4492
"2423",63030,"Crispano",999,5785,5914,11699
"2424",73004,"Crispiano",999,6434,6599,13033
"2425",4077,"Crissolo",999,86,63,149
"2426",10020,"Crocefieschi",999,288,244,532
"2427",26025,"Crocetta del Montello",999,2947,3043,5990
"2428",103026,"Crodo",999,712,724,1436
"2429",67023,"Crognaleto",999,599,459,1058
"2430",78046,"Cropalati",999,489,487,976
"2431",79036,"Cropani",999,2304,2424,4728
"2432",78047,"Crosia",999,4792,4880,9672
"2433",12057,"Crosio della Valle",999,329,308,637
"2434",101010,"Crotone",999,28573,29721,58294
"2435",19038,"Crotta d'Adda",999,317,299,616
"2436",2052,"Crova",999,182,168,350
"2437",22068,"Croviana",999,347,341,688
"2438",101011,"Crucoli",999,1308,1453,2761
"2439",12058,"Cuasso al Monte",999,1743,1798,3541
"2440",65049,"Cuccaro Vetere",999,239,282,521
"2441",13084,"Cucciago",999,1712,1705,3417
"2442",1096,"Cuceglio",999,460,454,914
"2443",15096,"Cuggiono",999,4007,4072,8079
"2444",12059,"Cugliate-Fabiasco",999,1559,1541,3100
"2445",95019,"Cuglieri",999,1206,1235,2441
"2446",68017,"Cugnoli",999,653,687,1340
"2447",1097,"Cumiana",999,3927,3919,7846
"2448",19039,"Cumignano sul Naviglio",999,207,195,402
"2449",12060,"Cunardo",999,1428,1467,2895
"2450",4078,"Cuneo",999,27173,28835,56008
"2451",5051,"Cunico",999,218,214,432
"2452",1098,"Cuorgnè",999,4749,4817,9566
"2453",69028,"Cupello",999,2358,2431,4789
"2454",44017,"Cupra Marittima",999,2615,2763,5378
"2455",42016,"Cupramontana",999,2164,2230,4394
"2456",18060,"Cura Carpignano",999,2468,2568,5036
"2457",95077,"Curcuris",999,151,151,302
"2458",3058,"Cureggio",999,1248,1332,2580
"2459",12061,"Curiglia con Monteviasco",999,86,67,153
"2460",79039,"Curinga",999,3207,3306,6513
"2461",96023,"Curino",999,228,250,478
"2462",16089,"Curno",999,3718,3819,7537
"2463",21027,"Curon Venosta/Graun im Vinschgau",999,1233,1140,2373
"2464",75025,"Cursi",999,1899,1938,3837
"2465",28036,"Curtarolo",999,3551,3618,7169
"2466",20021,"Curtatone",999,7146,7542,14688
"2467",61032,"Curti",999,3152,3471,6623
"2468",15097,"Cusago",999,2331,2374,4705
"2469",15098,"Cusano Milanino",999,8998,9914,18912
"2470",62026,"Cusano Mutri",999,1891,1855,3746
"2471",13085,"Cusino",999,123,109,232
"2472",16090,"Cusio",999,112,92,204
"2473",81007,"Custonaci",999,2632,2636,5268
"2474",101012,"Cutro",999,4619,4739,9358
"2475",75026,"Cutrofiano",999,4177,4507,8684
"2476",12062,"Cuveglio",999,1618,1723,3341
"2477",12063,"Cuvio",999,812,845,1657
"2478",15099,"Dairago",999,3115,3269,6384
"2479",16091,"Dalmine",999,11739,11879,23618
"2480",22071,"Dambel",999,214,191,405
"2481",25017,"Danta di Cadore",999,215,217,432
"2482",17065,"Darfo Boario Terme",999,7851,7936,15787
"2483",102007,"Dasà",999,526,552,1078
"2484",10021,"Davagna",999,963,865,1828
"2485",12064,"Daverio",999,1512,1557,3069
"2486",79042,"Davoli",999,2803,2839,5642
"2487",14025,"Dazio",999,239,273,512
"2488",92015,"Decimomannu",999,4212,4159,8371
"2489",111013,"Decimoputzu",999,2117,2052,4169
"2490",79043,"Decollatura",999,1424,1408,2832
"2491",9027,"Dego",999,868,928,1796
"2492",11012,"Deiva Marina",999,608,680,1288
"2493",14026,"Delebio",999,1680,1630,3310
"2494",85006,"Delia",999,1823,2041,3864
"2495",80031,"Delianuova",999,1460,1591,3051
"2496",71022,"Deliceto",999,1754,1743,3497
"2497",17066,"Dello",999,2888,2783,5671
"2498",4079,"Demonte",999,971,901,1872
"2499",6065,"Denice",999,82,82,164
"2500",22074,"Denno",999,631,624,1255
"2501",6066,"Dernice",999,85,92,177
"2502",19040,"Derovere",999,147,131,278
"2503",54017,"Deruta",999,4672,4809,9481
"2504",97030,"Dervio",999,1269,1295,2564
"2505",2054,"Desana",999,518,578,1096
"2506",17067,"Desenzano del Garda",999,13932,15319,29251
"2507",108023,"Desio",999,20488,21121,41609
"2508",91016,"Desulo",999,1012,1025,2037
"2509",78048,"Diamante",999,2432,2587,5019
"2510",8025,"Diano Arentino",999,350,349,699
"2511",8026,"Diano Castello",999,1073,1160,2233
"2512",4080,"Diano d'Alba",999,1802,1759,3561
"2513",8027,"Diano Marina",999,2603,2960,5563
"2514",8028,"Diano San Pietro",999,535,560,1095
"2515",48013,"Dicomano",999,2851,2718,5569
"2516",30032,"Dignano",999,1088,1145,2233
"2517",22233,"Dimaro Folgarida",999,1011,1081,2092
"2518",102008,"Dinami",999,871,886,1757
"2519",78049,"Dipignano",999,1975,2082,4057
"2520",75027,"Diso",999,1322,1479,2801
"2521",3060,"Divignano",999,713,725,1438
"2522",13087,"Dizzasco",999,313,330,643
"2523",21028,"Dobbiaco/Toblach",999,1702,1711,3413
"2524",31003,"Doberdò del Lago",999,636,691,1327
"2525",4081,"Dogliani",999,2310,2311,4621
"2526",69029,"Dogliola",999,166,148,314
"2527",30033,"Dogna",999,80,70,150
"2528",23031,"Dolcè",999,1264,1269,2533
"2529",8029,"Dolceacqua",999,1056,1092,2148
"2530",8030,"Dolcedo",999,636,621,1257
"2531",31004,"Dolegna del Collio",999,158,137,295
"2532",111014,"Dolianova",999,4718,4683,9401
"2533",27012,"Dolo",999,7303,7623,14926
"2534",97031,"Dolzago",999,1251,1308,2559
"2535",78050,"Domanico",999,464,467,931
"2536",13089,"Domaso",999,695,717,1412
"2537",25018,"Domegge di Cadore",999,1067,1168,2235
"2538",64031,"Domicella",999,931,913,1844
"2539",103028,"Domodossola",999,8423,9304,17727
"2540",111015,"Domus de Maria",999,830,810,1640
"2541",111016,"Domusnovas",999,2856,2952,5808
"2542",96024,"Donato",999,345,344,689
"2543",13090,"Dongo",999,1568,1604,3172
"2544",7023,"Donnas",999,1166,1228,2394
"2545",111017,"Donori",999,989,966,1955
"2546",91017,"Dorgali",999,4180,4144,8324
"2547",97032,"Dorio",999,160,170,330
"2548",3062,"Dormelletto",999,1201,1291,2492
"2549",18061,"Dorno",999,2269,2310,4579
"2550",96025,"Dorzano",999,275,259,534
"2551",20022,"Dosolo",999,1569,1607,3176
"2552",16092,"Dossena",999,457,426,883
"2553",13092,"Dosso del Liro",999,116,121,237
"2554",7024,"Doues",999,244,258,502
"2555",40011,"Dovadola",999,769,806,1575
"2556",19041,"Dovera",999,1866,1900,3766
"2557",37025,"Dozza",999,3246,3316,6562
"2558",61033,"Dragoni",999,901,1023,1924
"2559",102009,"Drapia",999,1048,1099,2147
"2560",22078,"Drena",999,298,300,598
"2561",30034,"Drenchia",999,50,51,101
"2562",15101,"Dresano",999,1532,1573,3105
"2563",22079,"Dro",999,2502,2559,5061
"2564",4082,"Dronero",999,3486,3518,7004
"2565",1099,"Druento",999,4392,4623,9015
"2566",103029,"Druogno",999,523,513,1036
"2567",91018,"Dualchi",999,279,284,563
"2568",14027,"Dubino",999,1917,1881,3798
"2569",28106,"Due Carrare",999,4523,4484,9007
"2570",24038,"Dueville",999,6649,6961,13610
"2571",62027,"Dugenta",999,1270,1377,2647
"2572",32001,"Duino-Aurisina",999,3949,4259,8208
"2573",12065,"Dumenza",999,719,717,1436
"2574",12066,"Duno",999,92,62,154
"2575",62028,"Durazzano",999,1050,1022,2072
"2576",70022,"Duronia",999,206,186,392
"2577",5052,"Dusino San Michele",999,579,510,1089
"2578",65050,"Eboli",999,19080,18521,37601
"2579",17068,"Edolo",999,2142,2241,4383
"2580",21029,"Egna/Neumarkt",999,2721,2808,5529
"2581",68018,"Elice",999,814,812,1626
"2582",91019,"Elini",999,273,277,550
"2583",97033,"Ello",999,571,613,1184
"2584",92108,"Elmas",999,4713,4796,9509
"2585",4083,"Elva",999,39,38,77
"2586",7025,"Emarèse",999,112,112,224
"2587",48014,"Empoli",999,23777,25226,49003
"2588",16093,"Endine Gaiano",999,1745,1707,3452
"2589",24039,"Enego",999,786,729,1515
"2590",30035,"Enemonzo",999,632,632,1264
"2591",86009,"Enna",999,12111,13256,25367
"2592",4084,"Entracque",999,377,374,751
"2593",16094,"Entratico",999,1004,979,1983
"2594",4085,"Envie",999,986,958,1944
"2595",76030,"Episcopia",999,626,655,1281
"2596",27013,"Eraclea",999,5911,6073,11984
"2597",13095,"Erba",999,7881,8357,16238
"2598",23032,"Erbè",999,937,972,1909
"2599",23033,"Erbezzo",999,453,381,834
"2600",17069,"Erbusco",999,4503,4284,8787
"2601",74006,"Erchie",999,3973,4198,8171
"2602",63064,"Ercolano",999,24110,25616,49726
"2603",81008,"Erice",999,12499,13503,26002
"2604",9028,"Erli",999,115,102,217
"2605",93019,"Erto e Casso",999,180,182,362
"2606",90088,"Erula",999,346,339,685
"2607",97034,"Erve",999,335,340,675
"2608",43016,"Esanatoglia",999,904,995,1899
"2609",111018,"Escalaplano",999,1104,951,2055
"2610",111019,"Escolca",999,258,281,539
"2611",17070,"Esine",999,2503,2554,5057
"2612",97035,"Esino Lario",999,379,372,751
"2613",60031,"Esperia",999,1780,1777,3557
"2614",90028,"Esporlatu",999,177,191,368
"2615",28037,"Este",999,7649,8288,15937
"2616",111020,"Esterzili",999,274,285,559
"2617",7026,"Etroubles",999,257,224,481
"2618",13097,"Eupilio",999,1276,1267,2543
"2619",1100,"Exilles",999,126,118,244
"2620",6067,"Fabbrica Curone",999,267,299,566
"2621",46036,"Fabbriche di Vergemoli",999,359,347,706
"2622",35021,"Fabbrico",999,3457,3331,6788
"2623",42017,"Fabriano",999,13980,14848,28828
"2624",56024,"Fabrica di Roma",999,4081,4118,8199
"2625",102010,"Fabrizia",999,929,1007,1936
"2626",55011,"Fabro",999,1255,1337,2592
"2627",30036,"Faedis",999,1387,1374,2761
"2628",14028,"Faedo Valtellino",999,256,242,498
"2629",39010,"Faenza",999,28987,29857,58844
"2630",71023,"Faeto",999,311,303,614
"2631",30037,"Fagagna",999,2952,3041,5993
"2632",13098,"Faggeto Lario",999,564,540,1104
"2633",73005,"Faggiano",999,1674,1715,3389
"2634",66042,"Fagnano Alto",999,173,176,349
"2635",78051,"Fagnano Castello",999,1623,1711,3334
"2636",12067,"Fagnano Olona",999,6173,6305,12478
"2637",62029,"Faicchio",999,1638,1639,3277
"2638",22081,"Fai della Paganella",999,465,468,933
"2639",25019,"Falcade",999,849,919,1768
"2640",61101,"Falciano del Massico",999,1630,1748,3378
"2641",78052,"Falconara Albanese",999,729,746,1475
"2642",42018,"Falconara Marittima",999,12497,13190,25687
"2643",83019,"Falcone",999,1367,1452,2819
"2644",56025,"Faleria",999,996,1015,2011
"2645",79047,"Falerna",999,2012,1865,3877
"2646",109005,"Falerone",999,1603,1540,3143
"2647",69104,"Fallo",999,62,54,116
"2648",13099,"Faloppio",999,2407,2457,4864
"2649",60032,"Falvaterra",999,261,252,513
"2650",21030,"Falzes/Pfalzen",999,1583,1565,3148
"2651",36011,"Fanano",999,1476,1497,2973
"2652",93020,"Fanna",999,729,742,1471
"2653",41013,"Fano",999,28926,31037,59963
"2654",67024,"Fano Adriano",999,146,116,262
"2655",69030,"Fara Filiorum Petri",999,994,979,1973
"2656",16096,"Fara Gera d'Adda",999,3999,4008,8007
"2657",57027,"Fara in Sabina",999,6884,6969,13853
"2658",3065,"Fara Novarese",999,1003,1010,2013
"2659",16097,"Fara Olivana con Sola",999,714,651,1365
"2660",69031,"Fara San Martino",999,636,632,1268
"2661",24040,"Fara Vicentino",999,1847,1863,3710
"2662",76031,"Fardella",999,286,286,572
"2663",4086,"Farigliano",999,850,848,1698
"2664",68019,"Farindola",999,644,684,1328
"2665",33019,"Farini",999,534,501,1035
"2666",56026,"Farnese",999,676,707,1383
"2667",26026,"Farra di Soligo",999,4196,4343,8539
"2668",31005,"Farra d'Isonzo",999,826,845,1671
"2669",74007,"Fasano",999,18897,19768,38665
"2670",10022,"Fascia",999,35,32,67
"2671",50014,"Fauglia",999,1801,1838,3639
"2672",4087,"Faule",999,240,250,490
"2673",10023,"Favale di Malvaro",999,217,210,427
"2674",84017,"Favara",999,15309,16142,31451
"2675",81009,"Favignana",999,2304,2209,4513
"2676",1101,"Favria",999,2480,2527,5007
"2677",4088,"Feisoglio",999,144,153,297
"2678",1102,"Feletto",999,1082,1082,2164
"2679",34013,"Felino",999,4549,4627,9176
"2680",65051,"Felitto",999,554,599,1153
"2681",6068,"Felizzano",999,1024,1065,2089
"2682",25021,"Feltre",999,9938,10530,20468
"2683",13100,"Fenegrò",999,1640,1613,3253
"2684",1103,"Fenestrelle",999,244,232,476
"2685",7027,"Fénis",999,850,914,1764
"2686",55012,"Ferentillo",999,883,895,1778
"2687",60033,"Ferentino",999,10009,10059,20068
"2688",89008,"Ferla",999,1109,1150,2259
"2689",41014,"Fermignano",999,4109,4136,8245
"2690",109006,"Fermo",999,17406,18487,35893
"2691",12068,"Ferno",999,3306,3359,6665
"2692",79048,"Feroleto Antico",999,965,992,1957
"2693",80032,"Feroleto della Chiesa",999,726,785,1511
"2694",77008,"Ferrandina",999,3963,3958,7921
"2695",38008,"Ferrara",999,61777,67778,129555
"2696",23034,"Ferrara di Monte Baldo",999,144,127,271
"2697",70023,"Ferrazzano",999,1661,1676,3337
"2698",12069,"Ferrera di Varese",999,339,344,683
"2699",18062,"Ferrera Erbognone",999,544,520,1064
"2700",5053,"Ferrere",999,746,732,1478
"2701",33020,"Ferriere",999,596,516,1112
"2702",80033,"Ferruzzano",999,339,397,736
"2703",57028,"Fiamignano",999,622,548,1170
"2704",1104,"Fiano",999,1324,1335,2659
"2705",58036,"Fiano Romano",999,8367,8100,16467
"2706",43017,"Fiastra",999,323,285,608
"2707",22083,"Fiavè",999,518,534,1052
"2708",82035,"Ficarazzi",999,6278,6549,12827
"2709",29021,"Ficarolo",999,1065,1102,2167
"2710",83020,"Ficarra",999,627,661,1288
"2711",55013,"Ficulle",999,769,775,1544
"2712",34014,"Fidenza",999,13273,14009,27282
"2713",21031,"Fiè allo Sciliar/Völs am Schlern",999,1826,1841,3667
"2714",22085,"Fierozzo",999,249,215,464
"2715",19043,"Fiesco",999,600,602,1202
"2716",48015,"Fiesole",999,6640,7143,13783
"2717",17071,"Fiesse",999,1007,1014,2021
"2718",27014,"Fiesso d'Artico",999,4204,4331,8535
"2719",29022,"Fiesso Umbertiano",999,1931,1951,3882
"2720",13101,"Figino Serenza",999,2421,2502,4923
"2721",48052,"Figline e Incisa Valdarno",999,11271,11887,23158
"2722",78053,"Figline Vegliaturo",999,554,566,1120
"2723",58037,"Filacciano",999,219,238,457
"2724",102011,"Filadelfia",999,2450,2565,5015
"2725",16098,"Filago",999,1529,1521,3050
"2726",102012,"Filandari",999,858,891,1749
"2727",45006,"Filattiera",999,1066,1104,2170
"2728",60034,"Filettino",999,286,249,535
"2729",69032,"Filetto",999,408,425,833
"2730",76032,"Filiano",999,1334,1351,2685
"2731",18063,"Filighera",999,411,412,823
"2732",94019,"Filignano",999,293,268,561
"2733",102013,"Filogaso",999,682,647,1329
"2734",42019,"Filottrano",999,4408,4483,8891
"2735",36012,"Finale Emilia",999,7498,7642,15140
"2736",9029,"Finale Ligure",999,5331,5733,11064
"2737",16099,"Fino del Monte",999,601,541,1142
"2738",13102,"Fino Mornasco",999,5015,5003,10018
"2739",16100,"Fiorano al Serio",999,1418,1519,2937
"2740",1105,"Fiorano Canavese",999,363,367,730
"2741",36013,"Fiorano Modenese",999,8328,8416,16744
"2742",33021,"Fiorenzuola d'Arda",999,7360,7604,14964
"2743",48017,"Firenze",999,171889,191948,363837
"2744",48018,"Firenzuola",999,2212,2216,4428
"2745",78054,"Firmo",999,909,911,1820
"2746",38027,"Fiscaglia",999,4134,4279,8413
"2747",65052,"Fisciano",999,7037,7092,14129
"2748",60035,"Fiuggi",999,4906,5196,10102
"2749",36014,"Fiumalbo",999,600,575,1175
"2750",80034,"Fiumara",999,404,438,842
"2751",83021,"Fiumedinisi",999,653,684,1337
"2752",78055,"Fiumefreddo Bruzio",999,1590,1572,3162
"2753",87016,"Fiumefreddo di Sicilia",999,4299,4733,9032
"2754",93021,"Fiume Veneto",999,5796,6041,11837
"2755",30190,"Fiumicello Villa Vicentina",999,3107,3194,6301
"2756",58120,"Fiumicino",999,41338,41168,82506
"2757",43019,"Fiuminata",999,614,644,1258
"2758",45007,"Fivizzano",999,3449,3592,7041
"2759",30039,"Flaibano",999,538,548,1086
"2760",17072,"Flero",999,4357,4375,8732
"2761",83022,"Floresta",999,239,236,475
"2762",89009,"Floridia",999,10440,10803,21243
"2763",90029,"Florinas",999,710,732,1442
"2764",64032,"Flumeri",999,1206,1270,2476
"2765",111021,"Fluminimaggiore",999,1274,1338,2612
"2766",95080,"Flussio",999,187,210,397
"2767",2057,"Fobello",999,108,76,184
"2768",71024,"Foggia",999,71942,73781,145723
"2769",62030,"Foglianise",999,1495,1609,3104
"2770",31006,"Fogliano Redipuglia",999,1429,1549,2978
"2771",1106,"Foglizzo",999,1091,1150,2241
"2772",51018,"Foiano della Chiana",999,4449,4626,9075
"2773",62031,"Foiano di Val Fortore",999,652,670,1322
"2774",22087,"Folgaria",999,1551,1624,3175
"2775",44020,"Folignano",999,4348,4391,8739
"2776",54018,"Foligno",999,26527,28769,55296
"2777",26027,"Follina",999,1737,1831,3568
"2778",11013,"Follo",999,3046,3052,6098
"2779",53009,"Follonica",999,9570,10749,20319
"2780",98026,"Fombio",999,1161,1098,2259
"2781",83023,"Fondachelli-Fantina",999,649,448,1097
"2782",59007,"Fondi",999,19854,19855,39709
"2783",91024,"Fonni",999,1763,1851,3614
"2784",7028,"Fontainemore",999,225,206,431
"2785",93022,"Fontanafredda",999,6411,6495,12906
"2786",60036,"Fontana Liri",999,1320,1363,2683
"2787",64033,"Fontanarosa",999,1402,1471,2873
"2788",37026,"Fontanelice",999,959,952,1911
"2789",16101,"Fontanella",999,2475,2407,4882
"2790",34015,"Fontanellato",999,3578,3535,7113
"2791",26028,"Fontanelle",999,2820,2889,5709
"2792",3066,"Fontaneto d'Agogna",999,1294,1313,2607
"2793",2058,"Fontanetto Po",999,521,519,1040
"2794",10024,"Fontanigorda",999,122,101,223
"2795",5054,"Fontanile",999,234,236,470
"2796",28038,"Fontaniva",999,4053,4021,8074
"2797",26029,"Fonte",999,3101,2944,6045
"2798",66043,"Fontecchio",999,140,148,288
"2799",60037,"Fontechiari",999,571,651,1222
"2800",61034,"Fontegreca",999,381,371,752
"2801",16102,"Fonteno",999,294,273,567
"2802",58122,"Fonte Nuova",999,16131,16621,32752
"2803",34016,"Fontevivo",999,2757,2728,5485
"2804",25022,"Fonzaso",999,1503,1516,3019
"2805",16103,"Foppolo",999,89,66,155
"2806",57029,"Forano",999,1643,1616,3259
"2807",44021,"Force",999,553,551,1104
"2808",62032,"Forchia",999,610,586,1196
"2809",14029,"Forcola",999,389,377,766
"2810",95020,"Fordongianus",999,393,422,815
"2811",76033,"Forenza",999,916,875,1791
"2812",16104,"Foresto Sparso",999,1571,1524,3095
"2813",30137,"Forgaria nel Friuli",999,846,843,1689
"2814",64034,"Forino",999,2569,2556,5125
"2815",63031,"Forio",999,8711,8756,17467
"2816",40012,"Forlì",999,57128,60082,117210
"2817",94020,"Forlì del Sannio",999,312,320,632
"2818",40013,"Forlimpopoli",999,6476,6629,13105
"2819",103031,"Formazza",999,214,219,433
"2820",58038,"Formello",999,6669,7096,13765
"2821",59008,"Formia",999,17702,19235,36937
"2822",61035,"Formicola",999,661,719,1380
"2823",19044,"Formigara",999,494,502,996
"2824",36015,"Formigine",999,17026,17448,34474
"2825",2059,"Formigliana",999,246,245,491
"2826",22089,"Fornace",999,684,652,1336
"2827",94021,"Fornelli",999,893,897,1790
"2828",30040,"Forni Avoltri",999,254,247,501
"2829",30041,"Forni di Sopra",999,466,448,914
"2830",30042,"Forni di Sotto",999,263,267,530
"2831",1107,"Forno Canavese",999,1600,1567,3167
"2832",34017,"Fornovo di Taro",999,2894,3075,5969
"2833",16105,"Fornovo San Giovanni",999,1711,1698,3409
"2834",46013,"Forte dei Marmi",999,3109,3644,6753
"2835",21032,"Fortezza/Franzensfeste",999,561,544,1105
"2836",18064,"Fortunago",999,190,170,360
"2837",83024,"Forza d'Agrò",999,427,418,845
"2838",46014,"Fosciandora",999,267,282,549
"2839",45008,"Fosdinovo",999,2259,2334,4593
"2840",66044,"Fossa",999,322,331,653
"2841",69033,"Fossacesia",999,3112,3134,6246
"2842",27015,"Fossalta di Piave",999,2058,2146,4204
"2843",27016,"Fossalta di Portogruaro",999,2798,2945,5743
"2844",70024,"Fossalto",999,557,587,1144
"2845",4089,"Fossano",999,12115,12103,24218
"2846",54019,"Fossato di Vico",999,1290,1314,2604
"2847",79052,"Fossato Serralta",999,274,276,550
"2848",27017,"Fossò",999,3467,3602,7069
"2849",41015,"Fossombrone",999,4506,4571,9077
"2850",24041,"Foza",999,354,303,657
"2851",4090,"Frabosa Soprana",999,430,324,754
"2852",4091,"Frabosa Sottana",999,869,730,1599
"2853",6069,"Fraconalto",999,163,142,305
"2854",73006,"Fragagnano",999,2381,2567,4948
"2855",62033,"Fragneto l'Abate",999,438,500,938
"2856",62034,"Fragneto Monforte",999,816,851,1667
"2857",69034,"Fraine",999,120,135,255
"2858",11014,"Framura",999,279,283,562
"2859",69035,"Francavilla al Mare",999,12168,13324,25492
"2860",102014,"Francavilla Angitola",999,916,893,1809
"2861",6070,"Francavilla Bisio",999,246,266,512
"2862",109007,"Francavilla d'Ete",999,463,440,903
"2863",83025,"Francavilla di Sicilia",999,1712,1811,3523
"2864",74008,"Francavilla Fontana",999,16830,17890,34720
"2865",76034,"Francavilla in Sinni",999,1912,1978,3890
"2866",78056,"Francavilla Marittima",999,1366,1394,2760
"2867",102015,"Francica",999,812,793,1605
"2868",89010,"Francofonte",999,5748,5928,11676
"2869",61036,"Francolise",999,2323,2296,4619
"2870",6071,"Frascaro",999,201,217,418
"2871",18065,"Frascarolo",999,540,558,1098
"2872",58039,"Frascati",999,10871,11978,22849
"2873",78057,"Frascineto",999,888,986,1874
"2874",22090,"Frassilongo",999,182,170,352
"2875",29023,"Frassinelle Polesine",999,650,664,1314
"2876",6072,"Frassinello Monferrato",999,218,243,461
"2877",6073,"Frassineto Po",999,658,709,1367
"2878",1108,"Frassinetto",999,156,114,270
"2879",4092,"Frassino",999,138,119,257
"2880",36016,"Frassinoro",999,864,856,1720
"2881",57030,"Frasso Sabino",999,381,390,771
"2882",62035,"Frasso Telesino",999,1013,987,2000
"2883",63032,"Frattamaggiore",999,13839,14753,28592
"2884",63033,"Frattaminore",999,7558,7823,15381
"2885",29024,"Fratta Polesine",999,1154,1285,2439
"2886",54020,"Fratta Todina",999,940,930,1870
"2887",41016,"Fratte Rosa",999,442,413,855
"2888",83026,"Frazzanò",999,272,290,562
"2889",26030,"Fregona",999,1369,1373,2742
"2890",69036,"Fresagrandinaria",999,451,461,912
"2891",6074,"Fresonara",999,333,300,633
"2892",64035,"Frigento",999,1719,1709,3428
"2893",61037,"Frignano",999,4432,4524,8956
"2894",5055,"Frinco",999,352,373,725
"2895",69037,"Frisa",999,809,817,1626
"2896",93024,"Frisanco",999,304,284,588
"2897",1109,"Front",999,799,784,1583
"2898",41017,"Frontino",999,144,153,297
"2899",41018,"Frontone",999,591,623,1214
"2900",60038,"Frosinone",999,20800,22654,43454
"2901",94022,"Frosolone",999,1423,1364,2787
"2902",1110,"Frossasco",999,1401,1426,2827
"2903",6075,"Frugarolo",999,904,974,1878
"2904",6076,"Fubine Monferrato",999,780,825,1605
"2905",48019,"Fucecchio",999,11232,11576,22808
"2906",16106,"Fuipiano Valle Imagna",999,106,103,209
"2907",23035,"Fumane",999,2154,2017,4171
"2908",60039,"Fumone",999,964,983,1947
"2909",21033,"Funes/Villnöß",999,1286,1269,2555
"2910",69038,"Furci",999,386,415,801
"2911",83027,"Furci Siculo",999,1567,1636,3203
"2912",83028,"Furnari",999,2074,2106,4180
"2913",65053,"Furore",999,364,319,683
"2914",111022,"Furtei",999,751,749,1500
"2915",78058,"Fuscaldo",999,3890,3887,7777
"2916",39011,"Fusignano",999,4044,4100,8144
"2917",14030,"Fusine",999,275,276,551
"2918",65054,"Futani",999,494,577,1071
"2919",19045,"Gabbioneta-Binanuova",999,431,422,853
"2920",6077,"Gabiano",999,517,500,1017
"2921",41019,"Gabicce Mare",999,2680,2781,5461
"2922",7029,"Gaby",999,212,206,418
"2923",19046,"Gadesco-Pieve Delmona",999,950,946,1896
"2924",91025,"Gadoni",999,309,346,655
"2925",59009,"Gaeta",999,9348,9984,19332
"2926",83029,"Gaggi",999,1496,1586,3082
"2927",15103,"Gaggiano",999,4571,4779,9350
"2928",37027,"Gaggio Montano",999,2433,2401,4834
"2929",96026,"Gaglianico",999,1805,2005,3810
"2930",66045,"Gagliano Aterno",999,116,108,224
"2931",86010,"Gagliano Castelferrato",999,1540,1661,3201
"2932",75028,"Gagliano del Capo",999,2367,2486,4853
"2933",79055,"Gagliato",999,193,224,417
"2934",43020,"Gagliole",999,267,251,518
"2935",26031,"Gaiarine",999,2932,2890,5822
"2936",29025,"Gaiba",999,478,486,964
"2937",4093,"Gaiola",999,299,282,581
"2938",52013,"Gaiole in Chianti",999,1260,1249,2509
"2939",91026,"Gairo",999,624,640,1264
"2940",21034,"Gais/Gais",999,1654,1571,3225
"2941",83030,"Galati Mamertino",999,1014,1197,2211
"2942",75029,"Galatina",999,12278,13233,25511
"2943",75030,"Galatone",999,7192,7686,14878
"2944",80035,"Galatro",999,686,742,1428
"2945",97036,"Galbiate",999,4120,4290,8410
"2946",40014,"Galeata",999,1264,1235,2499
"2947",98027,"Galgagnano",999,677,650,1327
"2948",12070,"Gallarate",999,26150,27107,53257
"2949",56027,"Gallese",999,1243,1325,2568
"2950",3068,"Galliate",999,7674,8041,15715
"2951",12071,"Galliate Lombardo",999,492,532,1024
"2952",18066,"Galliavola",999,78,91,169
"2953",46015,"Gallicano",999,1821,1786,3607
"2954",58040,"Gallicano nel Lazio",999,3286,3206,6492
"2955",76035,"Gallicchio",999,434,366,800
"2956",37028,"Galliera",999,2842,2787,5629
"2957",28039,"Galliera Veneta",999,3589,3549,7138
"2958",60040,"Gallinaro",999,567,615,1182
"2959",24042,"Gallio",999,1146,1192,2338
"2960",75031,"Gallipoli",999,9273,9839,19112
"2961",83031,"Gallodoro",999,161,163,324
"2962",61038,"Gallo Matese",999,226,229,455
"2963",61039,"Galluccio",999,1002,1024,2026
"2964",91027,"Galtellì",999,1161,1212,2373
"2965",28040,"Galzignano Terme",999,2111,2172,4283
"2966",6078,"Gamalero",999,365,429,794
"2967",17073,"Gambara",999,2315,2236,4551
"2968",18067,"Gambarana",999,91,101,192
"2969",4094,"Gambasca",999,181,169,350
"2970",48020,"Gambassi Terme",999,2371,2475,4846
"2971",70025,"Gambatesa",999,634,654,1288
"2972",24043,"Gambellara",999,1725,1735,3460
"2973",69039,"Gamberale",999,137,136,273
"2974",40015,"Gambettola",999,5296,5532,10828
"2975",18068,"Gambolò",999,4829,4915,9744
"2976",24044,"Gambugliano",999,458,390,848
"2977",16107,"Gandellino",999,507,457,964
"2978",16108,"Gandino",999,2540,2615,5155
"2979",16109,"Gandosso",999,751,701,1452
"2980",82036,"Gangi",999,2886,3127,6013
"2981",77009,"Garaguso",999,467,480,947
"2982",6079,"Garbagna",999,303,314,617
"2983",3069,"Garbagna Novarese",999,702,713,1415
"2984",15105,"Garbagnate Milanese",999,13151,13868,27019
"2985",97037,"Garbagnate Monastero",999,1308,1221,2529
"2986",23036,"Garda",999,2031,2082,4113
"2987",17074,"Gardone Riviera",999,1299,1308,2607
"2988",17075,"Gardone Val Trompia",999,5655,5693,11348
"2989",4095,"Garessio",999,1373,1459,2832
"2990",3070,"Gargallo",999,861,901,1762
"2991",21035,"Gargazzone/Gargazon",999,859,912,1771
"2992",17076,"Gargnano",999,1300,1365,2665
"2993",18069,"Garlasco",999,4651,4921,9572
"2994",97038,"Garlate",999,1285,1310,2595
"2995",9030,"Garlenda",999,685,694,1379
"2996",22091,"Garniga Terme",999,219,189,408
"2997",13106,"Garzeno",999,326,334,660
"2998",1111,"Garzigliana",999,270,268,538
"2999",79056,"Gasperina",999,934,927,1861
"3000",1112,"Gassino Torinese",999,4481,4788,9269
"3001",35022,"Gattatico",999,2889,2829,5718
"3002",40016,"Gatteo",999,4694,4690,9384
"3003",3166,"Gattico-Veruno",999,2574,2682,5256
"3004",2061,"Gattinara",999,3606,3911,7517
"3005",17077,"Gavardo",999,6320,6041,12361
"3006",29026,"Gavello",999,743,709,1452
"3007",16110,"Gaverina Terme",999,459,423,882
"3008",6081,"Gavi",999,2186,2205,4391
"3009",58041,"Gavignano",999,940,935,1875
"3010",12072,"Gavirate",999,4391,4779,9170
"3011",91028,"Gavoi",999,1207,1240,2447
"3012",53010,"Gavorrano",999,4119,4186,8305
"3013",20024,"Gazoldo degli Ippoliti",999,1552,1490,3042
"3014",12073,"Gazzada Schianno",999,2265,2348,4613
"3015",16111,"Gazzaniga",999,2392,2543,4935
"3016",28041,"Gazzo",999,2160,2146,4306
"3017",33022,"Gazzola",999,1095,1040,2135
"3018",23037,"Gazzo Veronese",999,2567,2591,5158
"3019",20025,"Gazzuolo",999,1035,1052,2087
"3020",85007,"Gela",999,34545,36266,70811
"3021",99004,"Gemmano",999,563,580,1143
"3022",30043,"Gemona del Friuli",999,5040,5480,10520
"3023",12074,"Gemonio",999,1410,1428,2838
"3024",58042,"Genazzano",999,2791,2878,5669
"3025",42020,"Genga",999,824,844,1668
"3026",19047,"Genivolta",999,564,552,1116
"3027",4096,"Genola",999,1298,1264,2562
"3028",111023,"Genoni",999,371,373,744
"3029",10025,"Genova",999,268874,293073,561947
"3030",111024,"Genuri",999,145,154,299
"3031",76036,"Genzano di Lucania",999,2587,2593,5180
"3032",58043,"Genzano di Roma",999,11004,11720,22724
"3033",80036,"Gerace",999,1155,1158,2313
"3034",82037,"Geraci Siculo",999,849,848,1697
"3035",13107,"Gera Lario",999,553,507,1060
"3036",58044,"Gerano",999,587,556,1143
"3037",18071,"Gerenzago",999,726,723,1449
"3038",12075,"Gerenzano",999,5366,5521,10887
"3039",111025,"Gergei",999,559,545,1104
"3040",1113,"Germagnano",999,584,530,1114
"3041",103032,"Germagno",999,97,88,185
"3042",12076,"Germignaga",999,1825,1883,3708
"3043",102016,"Gerocarne",999,979,956,1935
"3044",14031,"Gerola Alta",999,96,69,165
"3045",19048,"Gerre de' Caprioli",999,671,651,1322
"3046",111026,"Gesico",999,375,354,729
"3047",15106,"Gessate",999,4406,4381,8787
"3048",69040,"Gessopalena",999,566,607,1173
"3049",111027,"Gesturi",999,560,575,1135
"3050",64036,"Gesualdo",999,1589,1610,3199
"3051",17078,"Ghedi",999,9380,9166,18546
"3052",3073,"Ghemme",999,1672,1741,3413
"3053",103033,"Ghiffa",999,1128,1127,2255
"3054",95021,"Ghilarza",999,1959,2167,4126
"3055",16113,"Ghisalba",999,3092,3057,6149
"3056",2062,"Ghislarengo",999,409,399,808
"3057",29027,"Giacciano con Baruchella",999,1042,1019,2061
"3058",1114,"Giaglione",999,291,304,595
"3059",17079,"Gianico",999,1038,1066,2104
"3060",54021,"Giano dell'Umbria",999,1836,1825,3661
"3061",61040,"Giano Vetusto",999,296,327,623
"3062",82038,"Giardinello",999,1143,1098,2241
"3063",83032,"Giardini-Naxos",999,4440,4875,9315
"3064",6082,"Giarole",999,328,376,704
"3065",88004,"Giarratana",999,1449,1458,2907
"3066",87017,"Giarre",999,12836,13684,26520
"3067",90030,"Giave",999,243,235,478
"3068",1115,"Giaveno",999,7999,8334,16333
"3069",26032,"Giavera del Montello",999,2603,2516,5119
"3070",111028,"Giba",999,933,976,1909
"3071",81010,"Gibellina",999,1742,1942,3684
"3072",96027,"Gifflenga",999,56,45,101
"3073",80037,"Giffone",999,785,809,1594
"3074",65055,"Giffoni Sei Casali",999,2456,2478,4934
"3075",65056,"Giffoni Valle Piana",999,5691,5841,11532
"3076",103034,"Gignese",999,541,519,1060
"3077",7030,"Gignod",999,852,831,1683
"3078",70026,"Gildone",999,370,385,755
"3079",79058,"Gimigliano",999,1457,1494,2951
"3080",76099,"Ginestra",999,341,329,670
"3081",62036,"Ginestra degli Schiavoni",999,200,189,389
"3082",73007,"Ginosa",999,10939,10844,21783
"3083",65057,"Gioi",999,507,563,1070
"3084",66046,"Gioia dei Marsi",999,904,808,1712
"3085",72021,"Gioia del Colle",999,13018,13485,26503
"3086",61041,"Gioia Sannitica",999,1613,1639,3252
"3087",80038,"Gioia Tauro",999,9551,9685,19236
"3088",80039,"Gioiosa Ionica",999,3374,3442,6816
"3089",83033,"Gioiosa Marea",999,3299,3467,6766
"3090",55014,"Giove",999,896,933,1829
"3091",72022,"Giovinazzo",999,9290,9962,19252
"3092",22092,"Giovo",999,1284,1225,2509
"3093",91031,"Girasole",999,671,688,1359
"3094",79059,"Girifalco",999,2667,2792,5459
"3095",69041,"Gissi",999,1212,1256,2468
"3096",75032,"Giuggianello",999,547,581,1128
"3097",63034,"Giugliano in Campania",999,61202,62796,123998
"3098",82039,"Giuliana",999,843,829,1672
"3099",60041,"Giuliano di Roma",999,1137,1157,2294
"3100",69042,"Giuliano Teatino",999,560,559,1119
"3101",67025,"Giulianova",999,11178,12297,23475
"3102",65058,"Giungano",999,639,659,1298
"3103",75033,"Giurdignano",999,979,964,1943
"3104",18072,"Giussago",999,2709,2633,5342
"3105",108024,"Giussano",999,13046,13167,26213
"3106",9031,"Giustenice",999,499,516,1015
"3107",22093,"Giustino",999,360,380,740
"3108",9032,"Giusvalla",999,203,192,395
"3109",1116,"Givoletto",999,2060,2046,4106
"3110",79060,"Gizzeria",999,2779,2475,5254
"3111",21036,"Glorenza/Glurns",999,465,463,928
"3112",26033,"Godega di Sant'Urbano",999,2976,3031,6007
"3113",18073,"Godiasco Salice Terme",999,1584,1695,3279
"3114",82040,"Godrano",999,509,510,1019
"3115",20026,"Goito",999,5002,5048,10050
"3116",12077,"Golasecca",999,1303,1320,2623
"3117",18074,"Golferenzo",999,92,76,168
"3118",90083,"Golfo Aranci",999,1140,1248,2388
"3119",19049,"Gombito",999,328,292,620
"3120",30044,"Gonars",999,2215,2315,4530
"3121",111029,"Goni",999,246,194,440
"3122",111030,"Gonnesa",999,2280,2273,4553
"3123",95022,"Gonnoscodina",999,228,199,427
"3124",111031,"Gonnosfanadiga",999,2971,3130,6101
"3125",95023,"Gonnosnò",999,332,344,676
"3126",95024,"Gonnostramatza",999,391,405,796
"3127",20027,"Gonzaga",999,4438,4258,8696
"3128",14032,"Gordona",999,971,995,1966
"3129",58045,"Gorga",999,337,317,654
"3130",26034,"Gorgo al Monticano",999,1970,1881,3851
"3131",77010,"Gorgoglione",999,436,414,850
"3132",15108,"Gorgonzola",999,10274,10942,21216
"3133",66047,"Goriano Sicoli",999,272,244,516
"3134",31007,"Gorizia",999,16586,17142,33728
"3135",16114,"Gorlago",999,2603,2557,5160
"3136",12078,"Gorla Maggiore",999,2383,2448,4831
"3137",12079,"Gorla Minore",999,4057,4063,8120
"3138",16115,"Gorle",999,3180,3384,6564
"3139",12080,"Gornate Olona",999,1120,1059,2179
"3140",16116,"Gorno",999,741,735,1476
"3141",38025,"Goro",999,1648,1788,3436
"3142",10026,"Gorreto",999,46,46,92
"3143",4097,"Gorzegno",999,126,124,250
"3144",25025,"Gosaldo",999,273,248,521
"3145",33023,"Gossolengo",999,2819,2872,5691
"3146",4098,"Gottasecca",999,67,59,126
"3147",17080,"Gottolengo",999,2486,2536,5022
"3148",4099,"Govone",999,1087,1144,2231
"3149",3076,"Gozzano",999,2784,2757,5541
"3150",41020,"Gradara",999,2471,2418,4889
"3151",31008,"Gradisca d'Isonzo",999,3039,3386,6425
"3152",31009,"Grado",999,3638,3943,7581
"3153",56028,"Gradoli",999,610,629,1239
"3154",98028,"Graffignana",999,1337,1283,2620
"3155",56029,"Graffignano",999,1027,1061,2088
"3156",96028,"Graglia",999,690,747,1437
"3157",63035,"Gragnano",999,13634,14172,27806
"3158",33024,"Gragnano Trebbiense",999,2281,2314,4595
"3159",87018,"Grammichele",999,6080,6325,12405
"3160",5056,"Grana Monferrato",999,238,271,509
"3161",37030,"Granarolo dell'Emilia",999,6315,6581,12896
"3162",13110,"Grandate",999,1362,1482,2844
"3163",13111,"Grandola ed Uniti",999,647,645,1292
"3164",83034,"Graniti",999,742,711,1453
"3165",3077,"Granozzo con Monticello",999,646,667,1313
"3166",12081,"Grantola",999,599,626,1225
"3167",28042,"Grantorto",999,2252,2229,4481
"3168",28043,"Granze",999,923,965,1888
"3169",77011,"Grassano",999,2327,2324,4651
"3170",16117,"Grassobbio",999,3283,3237,6520
"3171",82041,"Gratteri",999,422,428,850
"3172",13249,"Gravedona ed Uniti",999,1984,2099,4083
"3173",18075,"Gravellona Lomellina",999,1343,1363,2706
"3174",103035,"Gravellona Toce",999,3655,3924,7579
"3175",1117,"Gravere",999,344,315,659
"3176",87019,"Gravina di Catania",999,12001,13291,25292
"3177",72023,"Gravina in Puglia",999,20986,21390,42376
"3178",61042,"Grazzanise",999,3387,3344,6731
"3179",5057,"Grazzano Badoglio",999,284,272,556
"3180",57031,"Greccio",999,730,734,1464
"3181",64037,"Greci",999,292,292,584
"3182",2065,"Greggio",999,168,157,325
"3183",6083,"Gremiasco",999,142,138,280
"3184",7031,"Gressan",999,1664,1710,3374
"3185",7032,"Gressoney-La-Trinité",999,155,169,324
"3186",7033,"Gressoney-Saint-Jean",999,380,381,761
"3187",48021,"Greve in Chianti",999,6566,6779,13345
"3188",15110,"Grezzago",999,1632,1552,3184
"3189",23038,"Grezzana",999,5389,5329,10718
"3190",13113,"Griante",999,284,299,583
"3191",61043,"Gricignano di Aversa",999,6463,6425,12888
"3192",3079,"Grignasco",999,2090,2225,4315
"3193",22095,"Grigno",999,1002,1020,2022
"3194",30045,"Grimacco",999,146,151,297
"3195",78059,"Grimaldi",999,769,741,1510
"3196",4100,"Grinzane Cavour",999,976,994,1970
"3197",24046,"Grisignano di Zocco",999,2140,2196,4336
"3198",78060,"Grisolia",999,1069,1102,2171
"3199",37031,"Grizzana Morandi",999,2016,1917,3933
"3200",6084,"Grognardo",999,131,99,230
"3201",16118,"Gromo",999,602,535,1137
"3202",6085,"Grondona",999,225,241,466
"3203",16119,"Grone",999,469,446,915
"3204",19050,"Grontardo",999,747,743,1490
"3205",18076,"Gropello Cairoli",999,2083,2195,4278
"3206",33025,"Gropparello",999,1120,1046,2166
"3207",1118,"Groscavallo",999,108,94,202
"3208",14033,"Grosio",999,2067,2226,4293
"3209",14034,"Grosotto",999,825,816,1641
"3210",53011,"Grosseto",999,39314,42322,81636
"3211",1119,"Grosso",999,485,509,994
"3212",58046,"Grottaferrata",999,9610,10819,20429
"3213",73008,"Grottaglie",999,14723,15731,30454
"3214",64038,"Grottaminarda",999,3751,3883,7634
"3215",44023,"Grottammare",999,7643,8247,15890
"3216",109008,"Grottazzolina",999,1550,1639,3189
"3217",84018,"Grotte",999,2432,2708,5140
"3218",56030,"Grotte di Castro",999,1251,1149,2400
"3219",80040,"Grotteria",999,1393,1445,2838
"3220",77012,"Grottole",999,993,990,1983
"3221",64039,"Grottolella",999,925,892,1817
"3222",27018,"Gruaro",999,1305,1407,2712
"3223",1120,"Grugliasco",999,17643,19121,36764
"3224",19051,"Grumello Cremonese ed Uniti",999,861,833,1694
"3225",16120,"Grumello del Monte",999,3726,3807,7533
"3226",76037,"Grumento Nova",999,762,775,1537
"3227",72024,"Grumo Appula",999,6139,5973,12112
"3228",24047,"Grumolo delle Abbadesse",999,1989,1901,3890
"3229",63036,"Grumo Nevano",999,8665,8459,17124
"3230",75034,"Guagnano",999,2547,2772,5319
"3231",43021,"Gualdo",999,344,374,718
"3232",54022,"Gualdo Cattaneo",999,2877,2751,5628
"3233",54023,"Gualdo Tadino",999,6804,7477,14281
"3234",35023,"Gualtieri",999,3153,3139,6292
"3235",83035,"Gualtieri Sicaminò",999,730,825,1555
"3236",111032,"Guamaggiore",999,441,451,892
"3237",13114,"Guanzate",999,2843,2896,5739
"3238",60042,"Guarcino",999,765,739,1504
"3239",2066,"Guardabosone",999,161,163,324
"3240",98029,"Guardamiglio",999,1349,1308,2657
"3241",79061,"Guardavalle",999,1985,2127,4112
"3242",29028,"Guarda Veneta",999,540,565,1105
"3243",55015,"Guardea",999,858,870,1728
"3244",69043,"Guardiagrele",999,4135,4182,8317
"3245",70027,"Guardialfiera",999,470,472,942
"3246",64040,"Guardia Lombardi",999,741,771,1512
"3247",76038,"Guardia Perticara",999,256,271,527
"3248",78061,"Guardia Piemontese",999,863,907,1770
"3249",70028,"Guardiaregia",999,354,335,689
"3250",62037,"Guardia Sanframondi",999,2244,2259,4503
"3251",50015,"Guardistallo",999,578,602,1180
"3252",4101,"Guarene",999,1741,1801,3542
"3253",111033,"Guasila",999,1233,1240,2473
"3254",35024,"Guastalla",999,7168,7462,14630
"3255",6086,"Guazzora",999,135,146,281
"3256",54024,"Gubbio",999,14774,15584,30358
"3257",15112,"Gudo Visconti",999,790,841,1631
"3258",70029,"Guglionesi",999,2469,2396,4865
"3259",20028,"Guidizzolo",999,2999,3002,6001
"3260",58047,"Guidonia Montecelio",999,44463,44948,89411
"3261",36017,"Guiglia",999,2117,2048,4165
"3262",69044,"Guilmi",999,219,198,417
"3263",103036,"Gurro",999,87,90,177
"3264",111034,"Guspini",999,5357,5494,10851
"3265",17081,"Gussago",999,8176,8421,16597
"3266",19052,"Gussola",999,1309,1342,2651
"3267",7034,"Hône",999,561,599,1160
"3268",17082,"Idro",999,928,938,1866
"3269",111035,"Iglesias",999,12015,12888,24903
"3270",4102,"Igliano",999,36,30,66
"3271",91032,"Ilbono",999,970,997,1967
"3272",23039,"Illasi",999,2606,2536,5142
"3273",90031,"Illorai",999,333,399,732
"3274",97039,"Imbersago",999,1241,1243,2484
"3275",22097,"Imer",999,609,568,1177
"3276",37032,"Imola",999,33509,35848,69357
"3277",8031,"Imperia",999,20733,21642,42375
"3278",48022,"Impruneta",999,6910,7458,14368
"3279",12082,"Inarzo",999,520,542,1062
"3280",5058,"Incisa Scapaccino",999,1040,987,2027
"3281",17083,"Incudine",999,167,180,347
"3282",12083,"Induno Olona",999,5093,5267,10360
"3283",1121,"Ingria",999,28,18,46
"3284",103037,"Intragna",999,54,41,95
"3285",97040,"Introbio",999,983,965,1948
"3286",7035,"Introd",999,329,322,651
"3287",66048,"Introdacqua",999,965,967,1932
"3288",13118,"Inverigo",999,4579,4657,9236
"3289",18077,"Inverno e Monteleone",999,751,714,1465
"3290",1122,"Inverso Pinasca",999,346,341,687
"3291",15113,"Inveruno",999,4135,4309,8444
"3292",3082,"Invorio",999,2104,2171,4275
"3293",15114,"Inzago",999,5602,5736,11338
"3294",102017,"Ionadi",999,2253,2339,4592
"3295",91033,"Irgoli",999,1106,1093,2199
"3296",17084,"Irma",999,70,59,129
"3297",77013,"Irsina",999,2299,2174,4473
"3298",4103,"Isasca",999,39,31,70
"3299",79063,"Isca sullo Ionio",999,737,734,1471
"3300",63037,"Ischia",999,9690,9904,19594
"3301",56031,"Ischia di Castro",999,1016,1088,2104
"3302",71025,"Ischitella",999,2061,2053,4114
"3303",17085,"Iseo",999,4294,4668,8962
"3304",22098,"Isera",999,1388,1415,2803
"3305",94023,"Isernia",999,10054,10677,20731
"3306",111036,"Isili",999,1188,1255,2443
"3307",82042,"Isnello",999,615,670,1285
"3308",1123,"Isolabella",999,177,186,363
"3309",8032,"Isolabona",999,334,343,677
"3310",5059,"Isola d'Asti",999,966,1004,1970
"3311",10027,"Isola del Cantone",999,698,687,1385
"3312",53012,"Isola del Giglio",999,678,606,1284
"3313",67026,"Isola del Gran Sasso d'Italia",999,2250,2224,4474
"3314",23040,"Isola della Scala",999,5870,5767,11637
"3315",82043,"Isola delle Femmine",999,3463,3576,7039
"3316",60043,"Isola del Liri",999,5142,5502,10644
"3317",41021,"Isola del Piano",999,278,262,540
"3318",101013,"Isola di Capo Rizzuto",999,9105,8568,17673
"3319",16121,"Isola di Fondra",999,89,83,172
"3320",19053,"Isola Dovarese",999,540,531,1071
"3321",23041,"Isola Rizza",999,1653,1620,3273
"3322",6087,"Isola Sant'Antonio",999,376,292,668
"3323",24048,"Isola Vicentina",999,5142,5194,10336
"3324",71026,"Isole Tremiti",999,277,216,493
"3325",17086,"Isorella",999,2089,1983,4072
"3326",65059,"Ispani",999,482,481,963
"3327",88005,"Ispica",999,8422,7964,16386
"3328",12084,"Ispra",999,2546,2766,5312
"3329",1124,"Issiglio",999,215,228,443
"3330",7036,"Issime",999,188,196,384
"3331",16122,"Isso",999,306,287,593
"3332",7037,"Issogne",999,646,646,1292
"3333",26035,"Istrana",999,4705,4421,9126
"3334",83036,"Itala",999,711,780,1491
"3335",59010,"Itri",999,5292,5133,10425
"3336",90032,"Ittireddu",999,239,224,463
"3337",90033,"Ittiri",999,3903,4025,7928
"3338",1125,"Ivrea",999,10766,11718,22484
"3339",19054,"Izano",999,993,961,1954
"3340",79065,"Jacurso",999,233,295,528
"3341",70030,"Jelsi",999,836,779,1615
"3342",58048,"Jenne",999,158,163,321
"3343",12085,"Jerago con Orago",999,2565,2596,5161
"3344",91035,"Jerzu",999,1461,1487,2948
"3345",42021,"Jesi",999,19095,20304,39399
"3346",27019,"Jesolo",999,13032,13829,26861
"3347",38010,"Jolanda di Savoia",999,1302,1323,2625
"3348",102018,"Joppolo",999,825,823,1648
"3349",84019,"Joppolo Giancaxio",999,509,552,1061
"3350",7038,"Jovençan",999,362,353,715
"3351",58049,"Labico",999,3206,3242,6448
"3352",57032,"Labro",999,180,174,354
"3353",1126,"La Cassa",999,889,883,1772
"3354",15115,"Lacchiarella",999,4503,4638,9141
"3355",63038,"Lacco Ameno",999,2207,2313,4520
"3356",64041,"Lacedonia",999,1021,1003,2024
"3357",21037,"Laces/Latsch",999,2595,2643,5238
"3358",95082,"Laconi",999,816,830,1646
"3359",58116,"Ladispoli",999,19929,20947,40876
"3360",90034,"Laerru",999,411,412,823
"3361",80041,"Laganadi",999,166,169,335
"3362",24049,"Laghi",999,64,63,127
"3363",13119,"Laglio",999,404,453,857
"3364",4104,"Lagnasco",999,739,661,1400
"3365",78062,"Lago",999,1130,1160,2290
"3366",76039,"Lagonegro",999,2404,2581,4985
"3367",38011,"Lagosanto",999,2246,2409,4655
"3368",21038,"Lagundo/Algund",999,2372,2593,4965
"3369",9033,"Laigueglia",999,792,918,1710
"3370",15116,"Lainate",999,12917,13419,26336
"3371",13120,"Laino",999,282,272,554
"3372",78063,"Laino Borgo",999,835,856,1691
"3373",78064,"Laino Castello",999,359,410,769
"3374",21039,"Laion/Lajen",999,1420,1393,2813
"3375",21040,"Laives/Leifers",999,9165,9265,18430
"3376",50016,"Lajatico",999,637,643,1280
"3377",16123,"Lallio",999,2056,2092,4148
"3378",1127,"La Loggia",999,4326,4398,8724
"3379",90035,"La Maddalena",999,5279,5294,10573
"3380",69045,"Lama dei Peligni",999,513,530,1043
"3381",7039,"La Magdeleine",999,55,45,100
"3382",36018,"Lama Mocogno",999,1321,1324,2645
"3383",13121,"Lambrugo",999,1249,1278,2527
"3384",79160,"Lamezia Terme",999,33194,34017,67211
"3385",25026,"Lamon",999,1264,1340,2604
"3386",4105,"La Morra",999,1341,1314,2655
"3387",84020,"Lampedusa e Linosa",999,3426,3112,6538
"3388",47005,"Lamporecchio",999,3635,3777,7412
"3389",2067,"Lamporo",999,243,241,484
"3390",21041,"Lana/Lana",999,6157,6384,12541
"3391",69046,"Lanciano",999,16351,17570,33921
"3392",3083,"Landiona",999,254,269,523
"3393",18078,"Landriano",999,3245,3272,6517
"3394",34018,"Langhirano",999,5456,5416,10872
"3395",18079,"Langosco",999,181,191,372
"3396",91037,"Lanusei",999,2488,2545,5033
"3397",58050,"Lanuvio",999,6435,6465,12900
"3398",14036,"Lanzada",999,660,598,1258
"3399",1128,"Lanzo Torinese",999,2404,2547,4951
"3400",109009,"Lapedona",999,584,573,1157
"3401",64042,"Lapio",999,731,706,1437
"3402",78065,"Lappano",999,442,426,868
"3403",66049,"L'Aquila",999,34474,35428,69902
"3404",47006,"Larciano",999,3075,3219,6294
"3405",18080,"Lardirago",999,621,557,1178
"3406",58115,"Lariano",999,6483,6704,13187
"3407",70031,"Larino",999,3149,3185,6334
"3408",21042,"Lasa/Laas",999,2059,2056,4115
"3409",7040,"La Salle",999,1021,1010,2031
"3410",82044,"Lascari",999,1821,1882,3703
"3411",13123,"Lasnigo",999,225,232,457
"3412",11015,"La Spezia",999,44972,47743,92715
"3413",111037,"Las Plassas",999,111,94,205
"3414",24050,"Lastebasse",999,90,93,183
"3415",48024,"Lastra a Signa",999,9760,10019,19779
"3416",56032,"Latera",999,408,354,762
"3417",51042,"Laterina Pergine Valdarno",999,3174,3191,6365
"3418",73009,"Laterza",999,7253,7500,14753
"3419",7041,"La Thuile",999,408,366,774
"3420",74009,"Latiano",999,6546,6909,13455
"3421",59011,"Latina",999,62386,65100,127486
"3422",30046,"Latisana",999,6357,6839,13196
"3423",76040,"Latronico",999,2009,2018,4027
"3424",78066,"Lattarico",999,1843,1876,3719
"3425",30047,"Lauco",999,329,323,652
"3426",65060,"Laureana Cilento",999,623,614,1237
"3427",80042,"Laureana di Borrello",999,2219,2364,4583
"3428",21043,"Lauregno/Laurein",999,177,141,318
"3429",76041,"Laurenzana",999,772,793,1565
"3430",76042,"Lauria",999,5711,6064,11775
"3431",1129,"Lauriano",999,701,701,1402
"3432",65061,"Laurino",999,627,618,1245
"3433",65062,"Laurito",999,348,350,698
"3434",64043,"Lauro",999,1592,1717,3309
"3435",10028,"Lavagna",999,5747,6561,12308
"3436",23042,"Lavagno",999,4255,4377,8632
"3437",25027,"La Valle Agordina",999,541,517,1058
"3438",97092,"La Valletta Brianza",999,2341,2302,4643
"3439",21117,"La Valle/Wengen",999,738,681,1419
"3440",22102,"Lavarone",999,611,592,1203
"3441",76043,"Lavello",999,6583,6361,12944
"3442",12086,"Lavena Ponte Tresa",999,2711,2958,5669
"3443",12087,"Laveno-Mombello",999,3931,4429,8360
"3444",17087,"Lavenone",999,243,245,488
"3445",65063,"Laviano",999,645,663,1308
"3446",22103,"Lavis",999,4571,4600,9171
"3447",23043,"Lazise",999,3428,3451,6879
"3448",108025,"Lazzate",999,3801,3882,7683
"3449",75035,"Lecce",999,45018,49416,94434
"3450",66050,"Lecce nei Marsi",999,746,785,1531
"3451",97042,"Lecco",999,22668,24477,47145
"3452",22229,"Ledro",999,2651,2744,5395
"3453",16124,"Leffe",999,2155,2181,4336
"3454",12088,"Leggiuno",999,1701,1852,3553
"3455",23044,"Legnago",999,12372,13243,25615
"3456",15118,"Legnano",999,29168,31275,60443
"3457",28044,"Legnaro",999,4778,4761,9539
"3458",91038,"Lei",999,226,221,447
"3459",1130,"Leini",999,8053,8269,16322
"3460",10029,"Leivi",999,1220,1228,2448
"3461",1131,"Lemie",999,91,66,157
"3462",29029,"Lendinara",999,5679,5781,11460
"3463",83037,"Leni",999,346,331,677
"3464",16125,"Lenna",999,264,291,555
"3465",17088,"Leno",999,7241,7182,14423
"3466",59012,"Lenola",999,2041,2025,4066
"3467",2068,"Lenta",999,386,383,769
"3468",108054,"Lentate sul Seveso",999,7883,7958,15841
"3469",69047,"Lentella",999,347,315,662
"3470",89011,"Lentini",999,10414,11009,21423
"3471",57033,"Leonessa",999,1047,1038,2085
"3472",86011,"Leonforte",999,5938,6245,12183
"3473",73010,"Leporano",999,4152,4082,8234
"3474",75036,"Lequile",999,4176,4427,8603
"3475",4106,"Lequio Berria",999,238,197,435
"3476",4107,"Lequio Tanaro",999,365,343,708
"3477",82045,"Lercara Friddi",999,2891,3222,6113
"3478",11016,"Lerici",999,4472,4893,9365
"3479",6088,"Lerma",999,386,416,802
"3480",3084,"Lesa",999,1026,1123,2149
"3481",4108,"Lesegno",999,440,407,847
"3482",34019,"Lesignano de' Bagni",999,2600,2505,5105
"3483",71027,"Lesina",999,3145,3086,6231
"3484",108026,"Lesmo",999,4111,4248,8359
"3485",1132,"Lessolo",999,851,891,1742
"3486",96085,"Lessona",999,1268,1333,2601
"3487",30048,"Lestizza",999,1788,1823,3611
"3488",61044,"Letino",999,294,334,628
"3489",83038,"Letojanni",999,1417,1497,2914
"3490",63039,"Lettere",999,3062,3001,6063
"3491",68020,"Lettomanoppello",999,1321,1342,2663
"3492",69048,"Lettopalena",999,172,143,315
"3493",11017,"Levanto",999,2410,2699,5109
"3494",16126,"Levate",999,1867,1853,3720
"3495",75037,"Leverano",999,6527,6947,13474
"3496",4109,"Levice",999,100,95,195
"3497",22104,"Levico Terme",999,4028,4236,8264
"3498",1133,"Levone",999,221,233,454
"3499",13126,"Lezzeno",999,942,976,1918
"3500",61045,"Liberi",999,530,542,1072
"3501",83039,"Librizzi",999,763,807,1570
"3502",84021,"Licata",999,16918,17271,34189
"3503",45009,"Licciana Nardi",999,2319,2406,4725
"3504",58051,"Licenza",999,456,436,892
"3505",87020,"Licodia Eubea",999,1376,1359,2735
"3506",97043,"Lierna",999,1083,1067,2150
"3507",2070,"Lignana",999,255,280,535
"3508",30049,"Lignano Sabbiadoro",999,3384,3491,6875
"3509",7042,"Lillianes",999,196,217,413
"3510",25029,"Limana",999,2692,2720,5412
"3511",62038,"Limatola",999,2247,2055,4302
"3512",102019,"Limbadi",999,1606,1611,3217
"3513",108027,"Limbiate",999,17397,17672,35069
"3514",28045,"Limena",999,4044,4169,8213
"3515",13128,"Limido Comasco",999,1954,1943,3897
"3516",83040,"Limina",999,339,388,727
"3517",4110,"Limone Piemonte",999,678,660,1338
"3518",17089,"Limone sul Garda",999,532,561,1093
"3519",70032,"Limosano",999,360,308,668
"3520",18081,"Linarolo",999,1385,1413,2798
"3521",87021,"Linguaglossa",999,2410,2553,4963
"3522",64044,"Lioni",999,2888,3023,5911
"3523",83041,"Lipari",999,6505,6180,12685
"3524",13129,"Lipomo",999,2885,3047,5932
"3525",18082,"Lirio",999,66,58,124
"3526",15122,"Liscate",999,2077,1984,4061
"3527",69049,"Liscia",999,336,306,642
"3528",54025,"Lisciano Niccone",999,305,311,616
"3529",4111,"Lisio",999,92,99,191
"3530",108028,"Lissone",999,22966,23775,46741
"3531",63040,"Liveri",999,713,757,1470
"3532",14037,"Livigno",999,3528,3274,6802
"3533",25030,"Livinallongo del Col di Lana",999,592,631,1223
"3534",22106,"Livo",999,393,373,766
"3535",13130,"Livo",999,91,73,164
"3536",49009,"Livorno",999,73869,79317,153186
"3537",2071,"Livorno Ferraris",999,2042,2170,4212
"3538",98030,"Livraga",999,1235,1263,2498
"3539",75038,"Lizzanello",999,5744,6002,11746
"3540",73011,"Lizzano",999,4658,4869,9527
"3541",37033,"Lizzano in Belvedere",999,1084,1116,2200
"3542",9034,"Loano",999,5027,5682,10709
"3543",5060,"Loazzolo",999,154,142,296
"3544",1134,"Locana",999,623,687,1310
"3545",15125,"Locate di Triulzi",999,5112,5209,10321
"3546",16127,"Locatello",999,417,408,825
"3547",13131,"Locate Varesino",999,2162,2156,4318
"3548",91039,"Loceri",999,637,661,1298
"3549",72025,"Locorotondo",999,6781,7120,13901
"3550",80043,"Locri",999,5710,6140,11850
"3551",91040,"Loculi",999,262,227,489
"3552",91041,"Lodè",999,763,727,1490
"3553",98031,"Lodi",999,21990,23202,45192
"3554",91104,"Lodine",999,155,145,300
"3555",98032,"Lodi Vecchio",999,3721,3947,7668
"3556",17090,"Lodrino",999,851,781,1632
"3557",17091,"Lograto",999,1909,1883,3792
"3558",37034,"Loiano",999,2263,2257,4520
"3559",90084,"Loiri Porto San Paolo",999,1899,1835,3734
"3560",97044,"Lomagna",999,2503,2535,5038
"3561",13133,"Lomazzo",999,4876,5103,9979
"3562",1135,"Lombardore",999,869,850,1719
"3563",1136,"Lombriasco",999,554,521,1075
"3564",18083,"Lomello",999,976,1064,2040
"3565",22108,"Lona-Lases",999,428,435,863
"3566",12089,"Lonate Ceppino",999,2506,2578,5084
"3567",12090,"Lonate Pozzolo",999,5661,5742,11403
"3568",17092,"Lonato del Garda",999,8469,8540,17009
"3569",48025,"Londa",999,943,885,1828
"3570",94024,"Longano",999,313,312,625
"3571",24051,"Longare",999,2717,2764,5481
"3572",25071,"Longarone",999,2430,2585,5015
"3573",17093,"Longhena",999,295,269,564
"3574",83042,"Longi",999,623,678,1301
"3575",40018,"Longiano",999,3588,3685,7273
"3576",78067,"Longobardi",999,1503,1385,2888
"3577",78068,"Longobucco",999,1250,1284,2534
"3578",13134,"Longone al Segrino",999,949,1004,1953
"3579",57034,"Longone Sabino",999,267,250,517
"3580",24052,"Lonigo",999,8033,7959,15992
"3581",1137,"Loranzè",999,572,570,1142
"3582",28046,"Loreggia",999,3890,3821,7711
"3583",103038,"Loreglia",999,102,108,210
"3584",25032,"Lorenzago di Cadore",999,284,271,555
"3585",29030,"Loreo",999,1608,1594,3202
"3586",42022,"Loreto",999,6293,6693,12986
"3587",68021,"Loreto Aprutino",999,3476,3573,7049
"3588",26036,"Loria",999,4753,4493,9246
"3589",51020,"Loro Ciuffenna",999,2921,2950,5871
"3590",43022,"Loro Piceno",999,1063,1086,2149
"3591",10030,"Lorsica",999,194,199,393
"3592",17094,"Losine",999,320,303,623
"3593",91042,"Lotzorai",999,1025,1098,2123
"3594",16128,"Lovere",999,2320,2681,5001
"3595",14038,"Lovero",999,313,304,617
"3596",17095,"Lozio",999,182,173,355
"3597",12091,"Lozza",999,591,592,1183
"3598",28047,"Lozzo Atestino",999,1545,1524,3069
"3599",25033,"Lozzo di Cadore",999,612,629,1241
"3600",2072,"Lozzolo",999,364,395,759
"3601",56033,"Lubriano",999,412,439,851
"3602",46017,"Lucca",999,42965,46171,89136
"3603",84022,"Lucca Sicula",999,834,863,1697
"3604",71028,"Lucera",999,14985,15729,30714
"3605",51021,"Lucignano",999,1656,1763,3419
"3606",8033,"Lucinasco",999,177,134,311
"3607",70033,"Lucito",999,312,318,630
"3608",66051,"Luco dei Marsi",999,3034,2895,5929
"3609",66052,"Lucoli",999,435,401,836
"3610",6193,"Lu e Cuccaro Monferrato",999,647,649,1296
"3611",33026,"Lugagnano Val d'Arda",999,1972,1959,3931
"3612",55016,"Lugnano in Teverina",999,707,699,1406
"3613",39012,"Lugo",999,15655,16612,32267
"3614",24053,"Lugo di Vicenza",999,1782,1750,3532
"3615",12092,"Luino",999,6769,7421,14190
"3616",13135,"Luisago",999,1368,1402,2770
"3617",91043,"Lula",999,629,617,1246
"3618",10031,"Lumarzo",999,722,701,1423
"3619",17096,"Lumezzane",999,10813,10763,21576
"3620",111038,"Lunamatrona",999,776,818,1594
"3621",41022,"Lunano",999,762,664,1426
"3622",18084,"Lungavilla",999,1163,1260,2423
"3623",78069,"Lungro",999,1069,1067,2136
"3624",11020,"Luni",999,4009,4097,8106
"3625",64045,"Luogosano",999,553,515,1068
"3626",90036,"Luogosanto",999,909,889,1798
"3627",70034,"Lupara",999,198,201,399
"3628",13136,"Lurago d'Erba",999,2733,2770,5503
"3629",13137,"Lurago Marinone",999,1307,1280,2587
"3630",16129,"Lurano",999,1452,1432,2884
"3631",90037,"Luras",999,1158,1210,2368
"3632",13138,"Lurate Caccivio",999,4740,4986,9726
"3633",61046,"Lusciano",999,7938,8265,16203
"3634",22109,"Luserna",999,130,137,267
"3635",1139,"Luserna San Giovanni",999,3483,3679,7162
"3636",1140,"Lusernetta",999,260,244,504
"3637",30051,"Lusevera",999,294,306,600
"3638",29031,"Lusia",999,1631,1647,3278
"3639",24127,"Lusiana Conco",999,2303,2253,4556
"3640",1141,"Lusigliè",999,262,292,554
"3641",21044,"Luson/Lüsen",999,792,791,1583
"3642",65064,"Lustra",999,517,496,1013
"3643",12093,"Luvinate",999,666,675,1341
"3644",16130,"Luzzana",999,459,440,899
"3645",35026,"Luzzara",999,4352,4248,8600
"3646",78070,"Luzzi",999,4292,4434,8726
"3647",12142,"Maccagno con Pino e Veddasca",999,1174,1187,2361
"3648",98033,"Maccastorna",999,37,24,61
"3649",94025,"Macchia d'Isernia",999,523,501,1024
"3650",94026,"Macchiagodena",999,807,819,1626
"3651",70035,"Macchia Valfortore",999,243,227,470
"3652",1142,"Macello",999,587,590,1177
"3653",43023,"Macerata",999,19575,20978,40553
"3654",61047,"Macerata Campania",999,4942,5084,10026
"3655",41023,"Macerata Feltria",999,887,1013,1900
"3656",108029,"Macherio",999,3796,3798,7594
"3657",17097,"Maclodio",999,749,755,1504
"3658",91044,"Macomer",999,4477,4716,9193
"3659",4112,"Macra",999,21,22,43
"3660",103039,"Macugnaga",999,260,245,505
"3661",61048,"Maddaloni",999,17870,18886,36756
"3662",14035,"Madesimo",999,271,244,515
"3663",19055,"Madignano",999,1387,1386,2773
"3664",16131,"Madone",999,2097,2064,4161
"3665",103040,"Madonna del Sasso",999,179,180,359
"3666",22243,"Madruzzo",999,1532,1459,2991
"3667",59013,"Maenza",999,1436,1493,2929
"3668",70036,"Mafalda",999,544,542,1086
"3669",17098,"Magasa",999,59,43,102
"3670",15130,"Magenta",999,11986,12612,24598
"3671",3088,"Maggiora",999,783,850,1633
"3672",18085,"Magherno",999,880,906,1786
"3673",54026,"Magione",999,7150,7510,14660
"3674",79068,"Magisano",999,533,542,1075
"3675",4113,"Magliano Alfieri",999,1040,1114,2154
"3676",4114,"Magliano Alpi",999,1093,1068,2161
"3677",66053,"Magliano de' Marsi",999,1708,1776,3484
"3678",109010,"Magliano di Tenna",999,725,696,1421
"3679",53013,"Magliano in Toscana",999,1561,1710,3271
"3680",58052,"Magliano Romano",999,702,681,1383
"3681",57035,"Magliano Sabina",999,1706,1737,3443
"3682",65065,"Magliano Vetere",999,273,291,564
"3683",75039,"Maglie",999,6272,7106,13378
"3684",9035,"Magliolo",999,487,481,968
"3685",1143,"Maglione",999,208,213,421
"3686",20029,"Magnacavallo",999,696,687,1383
"3687",15131,"Magnago",999,4716,4792,9508
"3688",96030,"Magnano",999,184,161,345
"3689",30052,"Magnano in Riviera",999,1130,1123,2253
"3690",95083,"Magomadas",999,311,293,604
"3691",13139,"Magreglio",999,353,341,694
"3692",21045,"Magrè sulla strada del vino/Margreid an der Weinstraße",999,649,679,1328
"3693",79069,"Maida",999,2206,2280,4486
"3694",78071,"Maierà",999,574,549,1123
"3695",102020,"Maierato",999,1030,1095,2125
"3696",42023,"Maiolati Spontini",999,2873,3113,5986
"3697",99022,"Maiolo",999,409,392,801
"3698",65066,"Maiori",999,2622,2698,5320
"3699",98034,"Mairago",999,701,671,1372
"3700",17099,"Mairano",999,1756,1722,3478
"3701",11018,"Maissana",999,324,268,592
"3702",30053,"Majano",999,2753,2994,5747
"3703",19056,"Malagnino",999,853,902,1755
"3704",37035,"Malalbergo",999,4490,4718,9208
"3705",30054,"Malborghetto Valbruna",999,466,430,896
"3706",23045,"Malcesine",999,1740,1836,3576
"3707",22110,"Malé",999,1097,1169,2266
"3708",17100,"Malegno",999,962,967,1929
"3709",98035,"Maleo",999,1488,1548,3036
"3710",103041,"Malesco",999,667,676,1343
"3711",87022,"Maletto",999,1720,1837,3557
"3712",83043,"Malfa",999,506,495,1001
"3713",97045,"Malgrate",999,2023,2165,4188
"3714",78072,"Malito",999,340,353,693
"3715",9036,"Mallare",999,518,552,1070
"3716",21046,"Malles Venosta/Mals",999,2684,2595,5279
"3717",12096,"Malnate",999,8039,8474,16513
"3718",24055,"Malo",999,7355,7385,14740
"3719",17101,"Malonno",999,1460,1515,2975
"3720",44027,"Maltignano",999,1078,1125,2203
"3721",83044,"Malvagna",999,284,324,608
"3722",6090,"Malvicino",999,33,45,78
"3723",78073,"Malvito",999,818,797,1615
"3724",80044,"Mammola",999,1178,1244,2422
"3725",91046,"Mamoiada",999,1183,1199,2382
"3726",53014,"Manciano",999,3420,3604,7024
"3727",83045,"Mandanici",999,232,261,493
"3728",111039,"Mandas",999,1001,978,1979
"3729",78074,"Mandatoriccio",999,1214,1203,2417
"3730",58053,"Mandela",999,457,446,903
"3731",97046,"Mandello del Lario",999,4856,5056,9912
"3732",3090,"Mandello Vitta",999,106,111,217
"3733",73012,"Manduria",999,14499,15274,29773
"3734",17102,"Manerba del Garda",999,2668,2683,5351
"3735",17103,"Manerbio",999,6657,6827,13484
"3736",71029,"Manfredonia",999,26639,26982,53621
"3737",4115,"Mango",999,641,613,1254
"3738",78075,"Mangone",999,958,950,1908
"3739",87057,"Maniace",999,1877,1881,3758
"3740",93025,"Maniago",999,5693,5794,11487
"3741",64046,"Manocalzati",999,1542,1485,3027
"3742",68022,"Manoppello",999,3291,3453,6744
"3743",26037,"Mansuè",999,2521,2440,4961
"3744",4116,"Manta",999,1863,1926,3789
"3745",14039,"Mantello",999,373,375,748
"3746",20030,"Mantova",999,23470,25748,49218
"3747",30055,"Manzano",999,3073,3270,6343
"3748",58054,"Manziana",999,3782,3983,7765
"3749",16132,"Mapello",999,3516,3430,6946
"3750",1316,"Mappano",999,3608,3711,7319
"3751",90038,"Mara",999,254,274,528
"3752",92037,"Maracalagonis",999,4033,3864,7897
"3753",36019,"Maranello",999,8645,8656,17301
"3754",63041,"Marano di Napoli",999,28039,29687,57726
"3755",23046,"Marano di Valpolicella",999,1549,1561,3110
"3756",58055,"Marano Equo",999,397,374,771
"3757",30056,"Marano Lagunare",999,828,858,1686
"3758",78076,"Marano Marchesato",999,1612,1724,3336
"3759",78077,"Marano Principato",999,1490,1543,3033
"3760",36020,"Marano sul Panaro",999,2622,2666,5288
"3761",3091,"Marano Ticino",999,773,807,1580
"3762",24056,"Marano Vicentino",999,4657,4627,9284
"3763",5061,"Maranzana",999,121,99,220
"3764",76044,"Maratea",999,2294,2348,4642
"3765",15134,"Marcallo con Casone",999,3143,3183,6326
"3766",20031,"Marcaria",999,3172,3229,6401
"3767",79071,"Marcedusa",999,190,179,369
"3768",58056,"Marcellina",999,3517,3518,7035
"3769",79072,"Marcellinara",999,1060,1113,2173
"3770",57036,"Marcetelli",999,31,26,57
"3771",17104,"Marcheno",999,2096,2073,4169
"3772",12097,"Marchirolo",999,1769,1820,3589
"3773",49010,"Marciana",999,996,1064,2060
"3774",49011,"Marciana Marina",999,915,954,1869
"3775",61049,"Marcianise",999,18692,19593,38285
"3776",51022,"Marciano della Chiana",999,1669,1782,3451
"3777",18086,"Marcignago",999,1224,1206,2430
"3778",27020,"Marcon",999,8888,8837,17725
"3779",21047,"Marebbe/Enneberg",999,1617,1556,3173
"3780",4117,"Marene",999,1683,1656,3339
"3781",26038,"Mareno di Piave",999,4739,4701,9440
"3782",1144,"Marentino",999,641,646,1287
"3783",5062,"Maretto",999,211,179,390
"3784",4118,"Margarita",999,701,714,1415
"3785",110005,"Margherita di Savoia",999,5452,5687,11139
"3786",97047,"Margno",999,206,185,391
"3787",20032,"Mariana Mantovana",999,401,419,820
"3788",13143,"Mariano Comense",999,12552,12873,25425
"3789",31010,"Mariano del Friuli",999,716,729,1445
"3790",85008,"Marianopoli",999,746,815,1561
"3791",63042,"Mariglianella",999,3941,3999,7940
"3792",63043,"Marigliano",999,14078,15165,29243
"3793",80045,"Marina di Gioiosa Ionica",999,3041,3263,6304
"3794",82046,"Marineo",999,2983,3080,6063
"3795",58057,"Marino",999,22648,23866,46514
"3796",21048,"Marlengo/Marling",999,1481,1379,2860
"3797",47007,"Marliana",999,1696,1561,3257
"3798",17105,"Marmentino",999,337,320,657
"3799",20033,"Marmirolo",999,3780,3866,7646
"3800",4119,"Marmora",999,30,28,58
"3801",12098,"Marnate",999,4013,4098,8111
"3802",17106,"Marone",999,1487,1608,3095
"3803",80046,"Maropati",999,634,672,1306
"3804",24057,"Marostica",999,6972,7061,14033
"3805",48026,"Marradi",999,1468,1417,2885
"3806",95025,"Marrubiu",999,2311,2239,4550
"3807",4120,"Marsaglia",999,110,105,215
"3808",81011,"Marsala",999,39509,40324,79833
"3809",54027,"Marsciano",999,8809,9209,18018
"3810",76045,"Marsico Nuovo",999,1829,1946,3775
"3811",76046,"Marsicovetere",999,2813,2850,5663
"3812",56034,"Marta",999,1537,1689,3226
"3813",75040,"Martano",999,4087,4416,8503
"3814",27021,"Martellago",999,10365,10879,21244
"3815",21049,"Martello/Martell",999,455,386,841
"3816",30057,"Martignacco",999,3306,3556,6862
"3817",19057,"Martignana di Po",999,1011,1005,2016
"3818",75041,"Martignano",999,777,790,1567
"3819",73013,"Martina Franca",999,22645,24213,46858
"3820",16133,"Martinengo",999,5581,5385,10966
"3821",4121,"Martiniana Po",999,441,335,776
"3822",67047,"Martinsicuro",999,8036,8329,16365
"3823",79073,"Martirano",999,410,413,823
"3824",79074,"Martirano Lombardo",999,466,482,948
"3825",90039,"Martis",999,227,232,459
"3826",80047,"Martone",999,229,241,470
"3827",98036,"Marudo",999,895,868,1763
"3828",73014,"Maruggio",999,2619,2615,5234
"3829",37036,"Marzabotto",999,3423,3462,6885
"3830",18087,"Marzano",999,896,810,1706
"3831",61050,"Marzano Appio",999,995,963,1958
"3832",64047,"Marzano di Nola",999,794,839,1633
"3833",78078,"Marzi",999,504,476,980
"3834",12099,"Marzio",999,163,141,304
"3835",111040,"Masainas",999,574,627,1201
"3836",15136,"Masate",999,1919,1909,3828
"3837",87023,"Mascali",999,7108,7289,14397
"3838",87024,"Mascalucia",999,15647,16458,32105
"3839",76047,"Maschito",999,717,732,1449
"3840",12100,"Masciago Primo",999,143,148,291
"3841",26039,"Maser",999,2515,2581,5096
"3842",103042,"Masera",999,723,729,1452
"3843",26040,"Maserada sul Piave",999,4509,4614,9123
"3844",28048,"Maserà di Padova",999,4620,4627,9247
"3845",28049,"Masi",999,868,915,1783
"3846",6091,"Masio",999,654,620,1274
"3847",38012,"Masi Torello",999,1095,1212,2307
"3848",13144,"Maslianico",999,1552,1583,3135
"3849",10032,"Masone",999,1629,1679,3308
"3850",45010,"Massa",999,31915,34072,65987
"3851",66054,"Massa d'Albe",999,695,656,1351
"3852",63092,"Massa di Somma",999,2441,2535,4976
"3853",47008,"Massa e Cozzile",999,3690,4083,7773
"3854",109011,"Massa Fermana",999,417,452,869
"3855",73015,"Massafra",999,15878,16071,31949
"3856",98037,"Massalengo",999,2277,2190,4467
"3857",39013,"Massa Lombarda",999,5450,5318,10768
"3858",63044,"Massa Lubrense",999,6948,7238,14186
"3859",53015,"Massa Marittima",999,3932,4250,8182
"3860",54028,"Massa Martana",999,1816,1805,3621
"3861",28050,"Massanzago",999,3087,2993,6080
"3862",46018,"Massarosa",999,10771,11086,21857
"3863",96031,"Massazza",999,317,265,582
"3864",1145,"Massello",999,32,25,57
"3865",96032,"Masserano",999,929,959,1888
"3866",44029,"Massignano",999,828,766,1594
"3867",22112,"Massimeno",999,74,64,138
"3868",9037,"Massimino",999,54,49,103
"3869",3093,"Massino Visconti",999,548,559,1107
"3870",103043,"Massiola",999,62,47,109
"3871",95026,"Masullas",999,523,484,1007
"3872",43024,"Matelica",999,4377,4703,9080
"3873",77014,"Matera",999,29175,30445,59620
"3874",1146,"Mathi",999,1839,1885,3724
"3875",75042,"Matino",999,5279,5589,10868
"3876",70037,"Matrice",999,517,526,1043
"3877",1147,"Mattie",999,337,346,683
"3878",71031,"Mattinata",999,2907,3024,5931
"3879",81012,"Mazara del Vallo",999,24845,25272,50117
"3880",17107,"Mazzano",999,6373,6324,12697
"3881",58058,"Mazzano Romano",999,1457,1475,2932
"3882",85009,"Mazzarino",999,5181,5646,10827
"3883",83046,"Mazzarrà Sant'Andrea",999,715,684,1399
"3884",87056,"Mazzarrone",999,2003,1984,3987
"3885",1148,"Mazzè",999,2098,2171,4269
"3886",22113,"Mazzin",999,293,311,604
"3887",14040,"Mazzo di Valtellina",999,500,519,1019
"3888",1149,"Meana di Susa",999,431,387,818
"3889",91047,"Meana Sardo",999,793,790,1583
"3890",108030,"Meda",999,11584,11909,23493
"3891",18088,"Mede",999,2908,3158,6066
"3892",31011,"Medea",999,475,471,946
"3893",34020,"Medesano",999,5384,5377,10761
"3894",37037,"Medicina",999,8216,8487,16703
"3895",15139,"Mediglia",999,6128,6109,12237
"3896",16250,"Medolago",999,1182,1167,2349
"3897",20034,"Medole",999,2137,2078,4215
"3898",36021,"Medolla",999,3154,3292,6446
"3899",26041,"Meduna di Livenza",999,1449,1467,2916
"3900",93026,"Meduno",999,745,749,1494
"3901",28052,"Megliadino San Vitale",999,898,892,1790
"3902",3095,"Meina",999,1094,1257,2351
"3903",29032,"Melara",999,818,863,1681
"3904",6092,"Melazzo",999,589,607,1196
"3905",40019,"Meldola",999,4944,5025,9969
"3906",10033,"Mele",999,1260,1261,2521
"3907",15140,"Melegnano",999,8623,9339,17962
"3908",75043,"Melendugno",999,4928,5108,10036
"3909",98038,"Meleti",999,232,222,454
"3910",76048,"Melfi",999,8423,8608,17031
"3911",80048,"Melicuccà",999,395,429,824
"3912",80049,"Melicucco",999,2398,2460,4858
"3913",89012,"Melilli",999,6653,6531,13184
"3914",101014,"Melissa",999,1585,1644,3229
"3915",75044,"Melissano",999,3220,3419,6639
"3916",63045,"Melito di Napoli",999,17815,18491,36306
"3917",80050,"Melito di Porto Salvo",999,5128,5308,10436
"3918",64048,"Melito Irpino",999,893,887,1780
"3919",62039,"Melizzano",999,856,832,1688
"3920",4122,"Melle",999,165,133,298
"3921",14041,"Mello",999,481,455,936
"3922",75045,"Melpignano",999,1020,1071,2091
"3923",21050,"Meltina/Mölten",999,889,845,1734
"3924",15142,"Melzo",999,8887,9535,18422
"3925",13145,"Menaggio",999,1522,1523,3045
"3926",18089,"Menconico",999,175,164,339
"3927",8034,"Mendatica",999,95,66,161
"3928",78079,"Mendicino",999,4515,4487,9002
"3929",84023,"Menfi",999,5733,6084,11817
"3930",58059,"Mentana",999,11165,11521,22686
"3931",27022,"Meolo",999,3111,3071,6182
"3932",6093,"Merana",999,88,91,179
"3933",21051,"Merano/Meran",999,20007,21390,41397
"3934",97048,"Merate",999,7153,7732,14885
"3935",12101,"Mercallo",999,899,906,1805
"3936",41025,"Mercatello sul Metauro",999,661,661,1322
"3937",41026,"Mercatino Conca",999,527,518,1045
"3938",65067,"Mercato San Severino",999,10470,11023,21493
"3939",40020,"Mercato Saraceno",999,3502,3342,6844
"3940",1150,"Mercenasco",999,697,630,1327
"3941",64049,"Mercogliano",999,5657,5943,11600
"3942",30058,"Mereto di Tomba",999,1269,1249,2518
"3943",42024,"Mergo",999,484,501,985
"3944",103044,"Mergozzo",999,1059,1090,2149
"3945",83047,"Merì",999,1119,1186,2305
"3946",28053,"Merlara",999,1253,1303,2556
"3947",98039,"Merlino",999,857,833,1690
"3948",13147,"Merone",999,2020,2020,4040
"3949",74010,"Mesagne",999,12585,13535,26120
"3950",14043,"Mese",999,926,931,1857
"3951",12102,"Mesenzana",999,860,875,1735
"3952",15144,"Mesero",999,2113,2122,4235
"3953",38014,"Mesola",999,3127,3268,6395
"3954",101015,"Mesoraca",999,2805,2948,5753
"3955",83048,"Messina",999,104666,113229,217895
"3956",28054,"Mestrino",999,5822,5995,11817
"3957",63046,"Meta",999,3738,4053,7791
"3958",108031,"Mezzago",999,2236,2240,4476
"3959",22114,"Mezzana",999,431,446,877
"3960",18090,"Mezzana Bigli",999,528,524,1052
"3961",96033,"Mezzana Mortigliengo",999,233,242,475
"3962",18091,"Mezzana Rabattone",999,230,228,458
"3963",23047,"Mezzane di Sotto",999,1249,1301,2550
"3964",10034,"Mezzanego",999,770,758,1528
"3965",18092,"Mezzanino",999,684,685,1369
"3966",22115,"Mezzano",999,799,786,1585
"3967",1152,"Mezzenile",999,367,354,721
"3968",22116,"Mezzocorona",999,2701,2810,5511
"3969",82047,"Mezzojuso",999,1266,1312,2578
"3970",16134,"Mezzoldo",999,81,82,163
"3971",22117,"Mezzolombardo",999,3782,3885,7667
"3972",3097,"Mezzomerico",999,610,606,1216
"3973",96034,"Miagliano",999,257,282,539
"3974",26042,"Miane",999,1543,1558,3101
"3975",3098,"Miasino",999,381,431,812
"3976",103045,"Miazzina",999,196,166,362
"3977",57037,"Micigliano",999,66,46,112
"3978",75046,"Miggiano",999,1504,1729,3233
"3979",69050,"Miglianico",999,2293,2325,4618
"3980",79077,"Miglierina",999,325,380,705
"3981",77015,"Miglionico",999,1242,1113,2355
"3982",10035,"Mignanego",999,1768,1782,3550
"3983",61051,"Mignano Monte Lungo",999,1471,1527,2998
"3984",15146,"Milano",999,667454,704396,1371850
"3985",83049,"Milazzo",999,14635,15363,29998
"3986",85010,"Milena",999,1298,1362,2660
"3987",102021,"Mileto",999,3150,3125,6275
"3988",95027,"Milis",999,706,688,1394
"3989",87025,"Militello in Val di Catania",999,3345,3384,6729
"3990",83050,"Militello Rosmarino",999,579,568,1147
"3991",9038,"Millesimo",999,1581,1678,3259
"3992",87026,"Milo",999,531,491,1022
"3993",17108,"Milzano",999,884,841,1725
"3994",87027,"Mineo",999,2154,2235,4389
"3995",23048,"Minerbe",999,2306,2283,4589
"3996",37038,"Minerbio",999,4421,4532,8953
"3997",75047,"Minervino di Lecce",999,1625,1819,3444
"3998",110006,"Minervino Murge",999,3968,4098,8066
"3999",65068,"Minori",999,1285,1302,2587
"4000",59014,"Minturno",999,10002,10274,20276
"4001",46019,"Minucciano",999,873,910,1783
"4002",9039,"Mioglia",999,250,260,510
"4003",27023,"Mira",999,18393,19225,37618
"4004",64050,"Mirabella Eclano",999,3302,3383,6685
"4005",87028,"Mirabella Imbaccari",999,1986,2228,4214
"4006",6094,"Mirabello Monferrato",999,606,610,1216
"4007",70038,"Mirabello Sannitico",999,993,1047,2040
"4008",18093,"Miradolo Terme",999,1954,1886,3840
"4009",94027,"Miranda",999,455,478,933
"4010",36022,"Mirandola",999,11904,12511,24415
"4011",27024,"Mirano",999,13185,13922,27107
"4012",83051,"Mirto",999,425,447,872
"4013",99005,"Misano Adriatico",999,6986,7150,14136
"4014",16135,"Misano di Gera d'Adda",999,1483,1487,2970
"4015",81025,"Misiliscemi",999,4241,4176,8417
"4016",82048,"Misilmeri",999,14370,14578,28948
"4017",108032,"Misinto",999,2843,2862,5705
"4018",97049,"Missaglia",999,4423,4483,8906
"4019",76049,"Missanello",999,232,250,482
"4020",87029,"Misterbianco",999,23819,24974,48793
"4021",83052,"Mistretta",999,2027,2288,4315
"4022",5063,"Moasca",999,278,231,509
"4023",10036,"Moconesi",999,1242,1166,2408
"4024",36023,"Modena",999,89889,95120,185009
"4025",88006,"Modica",999,25929,27513,53442
"4026",40022,"Modigliana",999,2135,2155,4290
"4027",95084,"Modolo",999,82,93,175
"4028",72027,"Modugno",999,17592,18560,36152
"4029",22118,"Moena",999,1241,1296,2537
"4030",97050,"Moggio",999,246,250,496
"4031",30059,"Moggio Udinese",999,804,809,1613
"4032",20035,"Moglia",999,2681,2710,5391
"4033",43025,"Mogliano",999,2117,2190,4307
"4034",26043,"Mogliano Veneto",999,13705,14217,27922
"4035",95028,"Mogorella",999,206,197,403
"4036",95029,"Mogoro",999,1922,1925,3847
"4037",62040,"Moiano",999,1980,2020,4000
"4038",30060,"Moimacco",999,799,803,1602
"4039",83053,"Moio Alcantara",999,333,353,686
"4040",16136,"Moio de' Calvi",999,98,109,207
"4041",65069,"Moio della Civitella",999,883,921,1804
"4042",4123,"Moiola",999,122,100,222
"4043",72028,"Mola di Bari",999,12038,12285,24323
"4044",6095,"Molare",999,964,1038,2002
"4045",46020,"Molazzana",999,487,494,981
"4046",72029,"Molfetta",999,27792,29453,57245
"4047",66055,"Molina Aterno",999,175,169,344
"4048",62041,"Molinara",999,697,741,1438
"4049",37039,"Molinella",999,7691,8035,15726
"4050",8035,"Molini di Triora",999,360,290,650
"4051",6096,"Molino dei Torti",999,313,264,577
"4052",70039,"Molise",999,80,66,146
"4053",76050,"Moliterno",999,1688,1845,3533
"4054",2078,"Mollia",999,51,48,99
"4055",80051,"Molochio",999,1053,1136,2189
"4056",97051,"Molteno",999,1773,1752,3525
"4057",13152,"Moltrasio",999,708,813,1521
"4058",22120,"Molveno",999,537,582,1119
"4059",5064,"Mombaldone",999,104,88,192
"4060",4124,"Mombarcaro",999,132,134,266
"4061",41027,"Mombaroccio",999,1047,1046,2093
"4062",5065,"Mombaruzzo",999,479,466,945
"4063",4125,"Mombasiglio",999,288,305,593
"4064",1153,"Mombello di Torino",999,206,202,408
"4065",6097,"Mombello Monferrato",999,436,483,919
"4066",5066,"Mombercelli",999,1002,1056,2058
"4067",3100,"Momo",999,1153,1238,2391
"4068",1154,"Mompantero",999,288,325,613
"4069",57038,"Mompeo",999,262,256,518
"4070",6098,"Momperone",999,101,96,197
"4071",70040,"Monacilioni",999,221,243,464
"4072",5067,"Monale",999,475,505,980
"4073",80052,"Monasterace",999,1665,1639,3304
"4074",5068,"Monastero Bormida",999,387,453,840
"4075",1155,"Monastero di Lanzo",999,162,159,321
"4076",4126,"Monastero di Vasco",999,617,649,1266
"4077",4127,"Monasterolo Casotto",999,40,41,81
"4078",16137,"Monasterolo del Castello",999,570,572,1142
"4079",4128,"Monasterolo di Savigliano",999,656,664,1320
"4080",26044,"Monastier di Treviso",999,2179,2227,4406
"4081",111041,"Monastir",999,2504,2240,4744
"4082",1156,"Moncalieri",999,27124,28799,55923
"4083",5069,"Moncalvo",999,1327,1440,2767
"4084",1157,"Moncenisio",999,24,25,49
"4085",6099,"Moncestino",999,91,99,190
"4086",4129,"Monchiero",999,296,276,572
"4087",34022,"Monchio delle Corti",999,446,381,827
"4088",2079,"Moncrivello",999,686,682,1368
"4089",5070,"Moncucco Torinese",999,438,425,863
"4090",99006,"Mondaino",999,659,685,1344
"4091",41028,"Mondavio",999,1768,1855,3623
"4092",41029,"Mondolfo",999,7156,7212,14368
"4093",4130,"Mondovì",999,10843,11225,22068
"4094",61052,"Mondragone",999,14309,14511,28820
"4095",10037,"Moneglia",999,1221,1295,2516
"4096",4131,"Monesiglio",999,275,301,576
"4097",31012,"Monfalcone",999,15512,14591,30103
"4098",4132,"Monforte d'Alba",999,958,961,1919
"4099",83054,"Monforte San Giorgio",999,1191,1257,2448
"4100",26045,"Monfumo",999,642,655,1297
"4101",5071,"Mongardino",999,424,420,844
"4102",37040,"Monghidoro",999,2007,1843,3850
"4103",102022,"Mongiana",999,311,302,613
"4104",6100,"Mongiardino Ligure",999,83,67,150
"4105",83055,"Mongiuffi Melia",999,262,259,521
"4106",96035,"Mongrando",999,1738,1864,3602
"4107",78080,"Mongrassano",999,720,739,1459
"4108",21052,"Monguelfo-Tesido/Welsberg-Taisten",999,1462,1444,2906
"4109",13153,"Monguzzo",999,1182,1170,2352
"4110",17109,"Moniga del Garda",999,1299,1351,2650
"4111",6101,"Monleale",999,283,274,557
"4112",17110,"Monno",999,245,272,517
"4113",72030,"Monopoli",999,23344,24503,47847
"4114",82049,"Monreale",999,19113,19663,38776
"4115",32002,"Monrupino",999,430,410,840
"4116",109012,"Monsampietro Morico",999,292,299,591
"4117",44031,"Monsampolo del Tronto",999,2231,2212,4443
"4118",42025,"Monsano",999,1564,1674,3238
"4119",28055,"Monselice",999,8349,8836,17185
"4120",92109,"Monserrato",999,8947,9874,18821
"4121",47009,"Monsummano Terme",999,10115,10706,20821
"4122",4133,"Montà",999,2284,2417,4701
"4123",5072,"Montabone",999,168,147,315
"4124",6102,"Montacuto",999,123,111,234
"4125",5073,"Montafia",999,488,459,947
"4126",70041,"Montagano",999,487,485,972
"4127",14044,"Montagna in Valtellina",999,1401,1554,2955
"4128",28056,"Montagnana",999,4378,4632,9010
"4129",83056,"Montagnareale",999,680,698,1378
"4130",21053,"Montagna sulla Strada del Vino/Montan an der Weinstraße",999,857,865,1722
"4131",64051,"Montaguto",999,160,178,338
"4132",48027,"Montaione",999,1697,1780,3477
"4133",83057,"Montalbano Elicona",999,1022,1055,2077
"4134",77016,"Montalbano Jonico",999,3206,3390,6596
"4135",52037,"Montalcino",999,2765,2857,5622
"4136",6103,"Montaldeo",999,99,109,208
"4137",6104,"Montaldo Bormida",999,287,299,586
"4138",4134,"Montaldo di Mondovì",999,268,261,529
"4139",4135,"Montaldo Roero",999,439,438,877
"4140",5074,"Montaldo Scarampi",999,348,357,705
"4141",1158,"Montaldo Torinese",999,352,355,707
"4142",47010,"Montale",999,5168,5377,10545
"4143",1159,"Montalenghe",999,478,491,969
"4144",84024,"Montallegro",999,1170,1179,2349
"4145",8068,"Montalto Carpasio",999,268,252,520
"4146",44032,"Montalto delle Marche",999,856,993,1849
"4147",56035,"Montalto di Castro",999,4340,4372,8712
"4148",1160,"Montalto Dora",999,1647,1677,3324
"4149",18094,"Montalto Pavese",999,443,397,840
"4150",78081,"Montalto Uffugo",999,9836,10251,20087
"4151",1161,"Montanaro",999,2483,2573,5056
"4152",98040,"Montanaso Lombardo",999,1117,1129,2246
"4153",4136,"Montanera",999,379,336,715
"4154",65070,"Montano Antilia",999,801,873,1674
"4155",13154,"Montano Lucino",999,2699,2709,5408
"4156",109013,"Montappone",999,762,775,1537
"4157",94028,"Montaquila",999,1151,1122,2273
"4158",57039,"Montasola",999,199,197,396
"4159",79080,"Montauro",999,879,942,1821
"4160",69051,"Montazzoli",999,405,405,810
"4161",53016,"Monte Argentario",999,5732,6061,11793
"4162",18095,"Montebello della Battaglia",999,725,719,1444
"4163",68023,"Montebello di Bertona",999,421,418,839
"4164",80053,"Montebello Jonico",999,2768,2837,5605
"4165",69009,"Montebello sul Sangro",999,39,47,86
"4166",24060,"Montebello Vicentino",999,3224,3116,6340
"4167",26046,"Montebelluna",999,15272,16009,31281
"4168",10038,"Montebruno",999,99,102,201
"4169",57040,"Montebuono",999,407,394,801
"4170",41030,"Montecalvo in Foglia",999,1349,1399,2748
"4171",64052,"Montecalvo Irpino",999,1591,1695,3286
"4172",18096,"Montecalvo Versiggia",999,249,253,502
"4173",46021,"Montecarlo",999,2156,2285,4441
"4174",42026,"Montecarotto",999,909,940,1849
"4175",43026,"Montecassiano",999,3375,3427,6802
"4176",6105,"Montecastello",999,136,144,280
"4177",54029,"Monte Castello di Vibio",999,714,702,1416
"4178",55017,"Montecastrilli",999,2344,2445,4789
"4179",47011,"Montecatini-Terme",999,10077,11103,21180
"4180",50019,"Montecatini Val di Cecina",999,830,857,1687
"4181",43027,"Monte Cavallo",999,55,47,102
"4182",23049,"Montecchia di Crosara",999,2211,2085,4296
"4183",55018,"Montecchio",999,757,739,1496
"4184",35027,"Montecchio Emilia",999,5058,5400,10458
"4185",24061,"Montecchio Maggiore",999,12066,11525,23591
"4186",24062,"Montecchio Precalcino",999,2434,2480,4914
"4187",41031,"Monte Cerignone",999,274,314,588
"4188",6106,"Montechiaro d'Acqui",999,268,238,506
"4189",5075,"Montechiaro d'Asti",999,626,628,1254
"4190",34023,"Montechiarugolo",999,5659,5603,11262
"4191",70042,"Montecilfone",999,604,615,1219
"4192",58060,"Monte Compatri",999,5846,5978,11824
"4193",99030,"Montecopiolo",999,523,524,1047
"4194",65071,"Montecorice",999,1308,1255,2563
"4195",65072,"Montecorvino Pugliano",999,5604,5522,11126
"4196",65073,"Montecorvino Rovella",999,6181,6128,12309
"4197",43028,"Montecosaro",999,3691,3720,7411
"4198",19058,"Monte Cremasco",999,1118,1135,2253
"4199",103046,"Montecrestese",999,613,646,1259
"4200",36024,"Montecreto",999,504,438,942
"4201",24063,"Monte di Malo",999,1441,1378,2819
"4202",44034,"Montedinove",999,249,207,456
"4203",63047,"Monte di Procida",999,5717,6115,11832
"4204",85011,"Montedoro",999,652,704,1356
"4205",64053,"Montefalcione",999,1503,1552,3055
"4206",54030,"Montefalco",999,2631,2695,5326
"4207",109014,"Montefalcone Appennino",999,183,183,366
"4208",62042,"Montefalcone di Val Fortore",999,592,700,1292
"4209",70043,"Montefalcone nel Sannio",999,683,666,1349
"4210",43029,"Montefano",999,1616,1680,3296
"4211",41034,"Montefelcino",999,1263,1223,2486
"4212",69052,"Monteferrante",999,57,51,108
"4213",56036,"Montefiascone",999,6335,6672,13007
"4214",67027,"Montefino",999,469,460,929
"4215",99008,"Montefiore Conca",999,1150,1163,2313
"4216",44036,"Montefiore dell'Aso",999,948,1017,1965
"4217",36025,"Montefiorino",999,1077,1033,2110
"4218",58061,"Monteflavio",999,545,619,1164
"4219",65074,"Monteforte Cilento",999,283,264,547
"4220",23050,"Monteforte d'Alpone",999,4538,4395,8933
"4221",64054,"Monteforte Irpino",999,5796,5642,11438
"4222",109015,"Montefortino",999,518,519,1037
"4223",55019,"Montefranco",999,642,646,1288
"4224",64055,"Montefredane",999,1071,1056,2127
"4225",64056,"Montefusco",999,595,591,1186
"4226",55020,"Montegabbione",999,558,559,1117
"4227",24064,"Montegalda",999,1655,1703,3358
"4228",24065,"Montegaldella",999,890,908,1798
"4229",44038,"Montegallo",999,220,188,408
"4230",109016,"Monte Giberto",999,365,363,728
"4231",6107,"Montegioco",999,144,129,273
"4232",78082,"Montegiordano",999,736,801,1537
"4233",109017,"Montegiorgio",999,3087,3204,6291
"4234",109018,"Montegranaro",999,6270,6230,12500
"4235",99009,"Montegridolfo",999,490,491,981
"4236",41035,"Monte Grimano Terme",999,562,565,1127
"4237",12103,"Montegrino Valtravaglia",999,739,764,1503
"4238",5076,"Montegrosso d'Asti",999,1190,1156,2346
"4239",8037,"Montegrosso Pian Latte",999,55,56,111
"4240",28057,"Montegrotto Terme",999,5508,5962,11470
"4241",73016,"Monteiasi",999,2548,2729,5277
"4242",17111,"Monte Isola",999,805,804,1609
"4243",41036,"Montelabbate",999,3612,3480,7092
"4244",58062,"Montelanico",999,1013,1017,2030
"4245",69053,"Montelapiano",999,30,38,68
"4246",109019,"Monteleone di Fermo",999,188,164,352
"4247",71032,"Monteleone di Puglia",999,506,450,956
"4248",54031,"Monteleone di Spoleto",999,279,273,552
"4249",55021,"Monteleone d'Orvieto",999,637,719,1356
"4250",90040,"Monteleone Rocca Doria",999,47,55,102
"4251",57041,"Monteleone Sabino",999,569,590,1159
"4252",82050,"Montelepre",999,2767,2946,5713
"4253",58063,"Montelibretti",999,2470,2669,5139
"4254",64057,"Montella",999,3544,3737,7281
"4255",16139,"Montello",999,1649,1571,3220
"4256",70044,"Montelongo",999,154,141,295
"4257",109020,"Montelparo",999,359,340,699
"4258",4137,"Montelupo Albese",999,234,240,474
"4259",48028,"Montelupo Fiorentino",999,6947,7361,14308
"4260",43030,"Montelupone",999,1680,1687,3367
"4261",82051,"Montemaggiore Belsito",999,1372,1523,2895
"4262",5077,"Montemagno",999,482,555,1037
"4263",4138,"Montemale di Cuneo",999,120,113,233
"4264",64058,"Montemarano",999,1298,1302,2600
"4265",42027,"Montemarciano",999,4849,4940,9789
"4266",97052,"Monte Marenzo",999,906,911,1817
"4267",6108,"Montemarzino",999,159,153,312
"4268",73017,"Montemesola",999,1711,1802,3513
"4269",13155,"Montemezzo",999,105,96,201
"4270",51023,"Montemignaio",999,257,253,510
"4271",64059,"Montemiletto",999,2528,2528,5056
"4272",76051,"Montemilone",999,685,686,1371
"4273",70045,"Montemitro",999,139,141,280
"4274",44044,"Montemonaco",999,260,273,533
"4275",100003,"Montemurlo",999,9444,9663,19107
"4276",76052,"Montemurro",999,520,539,1059
"4277",30061,"Montenars",999,248,235,483
"4278",70046,"Montenero di Bisaccia",999,3127,3110,6237
"4279",69054,"Montenerodomo",999,309,287,596
"4280",57042,"Montenero Sabino",999,138,129,267
"4281",94029,"Montenero Val Cocchiara",999,253,227,480
"4282",69055,"Monteodorisio",999,1170,1167,2337
"4283",79081,"Montepaone",999,2845,2887,5732
"4284",73018,"Monteparano",999,1115,1180,2295
"4285",41038,"Monte Porzio",999,1406,1393,2799
"4286",58064,"Monte Porzio Catone",999,4171,4410,8581
"4287",44045,"Monteprandone",999,6519,6532,13051
"4288",52015,"Montepulciano",999,6366,6871,13237
"4289",51024,"Monterchi",999,844,865,1709
"4290",66056,"Montereale",999,1151,1042,2193
"4291",93027,"Montereale Valcellina",999,2051,2180,4231
"4292",37041,"Monterenzio",999,3072,3055,6127
"4293",52016,"Monteriggioni",999,4932,5095,10027
"4294",109021,"Monte Rinaldo",999,160,154,314
"4295",42029,"Monte Roberto",999,1479,1504,2983
"4296",94030,"Monteroduni",999,1071,1035,2106
"4297",56037,"Monte Romano",999,935,954,1889
"4298",52017,"Monteroni d'Arbia",999,4413,4647,9060
"4299",75048,"Monteroni di Lecce",999,6432,6801,13233
"4300",56038,"Monterosi",999,2395,2395,4790
"4301",11019,"Monterosso al Mare",999,607,710,1317
"4302",88007,"Monterosso Almo",999,1346,1407,2753
"4303",102023,"Monterosso Calabro",999,726,744,1470
"4304",4139,"Monterosso Grana",999,310,226,536
"4305",58065,"Monterotondo",999,19971,21220,41191
"4306",53027,"Monterotondo Marittimo",999,671,630,1301
"4307",109022,"Monterubbiano",999,1003,1006,2009
"4308",59015,"Monte San Biagio",999,3083,2970,6053
"4309",65075,"Monte San Giacomo",999,687,719,1406
"4310",60044,"Monte San Giovanni Campano",999,5972,6010,11982
"4311",57043,"Monte San Giovanni in Sabina",999,339,311,650
"4312",43031,"Monte San Giusto",999,3709,3758,7467
"4313",43032,"Monte San Martino",999,349,340,689
"4314",75049,"Montesano Salentino",999,1261,1337,2598
"4315",65076,"Montesano sulla Marcellana",999,3088,3133,6221
"4316",109023,"Monte San Pietrangeli",999,1081,1125,2206
"4317",37042,"Monte San Pietro",999,5323,5481,10804
"4318",51025,"Monte San Savino",999,4181,4398,8579
"4319",54032,"Monte Santa Maria Tiberina",999,541,543,1084
"4320",71033,"Monte Sant'Angelo",999,5497,5738,11235
"4321",42030,"Monte San Vito",999,3292,3397,6689
"4322",62043,"Montesarchio",999,6435,6562,12997
"4323",77017,"Montescaglioso",999,4578,4662,9240
"4324",18097,"Montescano",999,200,209,409
"4325",103047,"Montescheno",999,189,180,369
"4326",50020,"Montescudaio",999,1084,1099,2183
"4327",99029,"Montescudo-Monte Colombo",999,3509,3400,6909
"4328",36026,"Montese",999,1671,1647,3318
"4329",18098,"Montesegale",999,132,120,252
"4330",68024,"Montesilvano",999,25893,27672,53565
"4331",48030,"Montespertoli",999,6515,6659,13174
"4332",1162,"Monteu da Po",999,427,417,844
"4333",109024,"Monte Urano",999,3913,3943,7856
"4334",4140,"Monteu Roero",999,821,779,1600
"4335",84025,"Montevago",999,1299,1362,2661
"4336",51026,"Montevarchi",999,11934,12274,24208
"4337",97053,"Montevecchia",999,1346,1333,2679
"4338",64060,"Monteverde",999,345,350,695
"4339",50021,"Monteverdi Marittimo",999,393,401,794
"4340",24066,"Monteviale",999,1393,1388,2781
"4341",109025,"Monte Vidon Combatte",999,193,208,401
"4342",109026,"Monte Vidon Corrado",999,348,335,683
"4343",4141,"Montezemolo",999,115,105,220
"4344",90041,"Monti",999,1175,1171,2346
"4345",40028,"Montiano",999,834,854,1688
"4346",17112,"Monticelli Brusati",999,2322,2277,4599
"4347",33027,"Monticelli d'Ongina",999,2559,2607,5166
"4348",18099,"Monticelli Pavese",999,296,339,635
"4349",97054,"Monticello Brianza",999,2044,2073,4117
"4350",24067,"Monticello Conte Otto",999,4495,4601,9096
"4351",4142,"Monticello d'Alba",999,1168,1185,2353
"4352",17113,"Montichiari",999,13269,13098,26367
"4353",52018,"Monticiano",999,899,752,1651
"4354",53017,"Montieri",999,606,567,1173
"4355",5121,"Montiglio Monferrato",999,739,745,1484
"4356",45011,"Montignoso",999,4906,5152,10058
"4357",17114,"Montirone",999,2567,2488,5055
"4358",7043,"Montjovet",999,889,862,1751
"4359",19059,"Montodine",999,1208,1234,2442
"4360",10039,"Montoggio",999,1020,977,1997
"4361",54033,"Montone",999,755,791,1546
"4362",57044,"Montopoli di Sabina",999,2051,2038,4089
"4363",50022,"Montopoli in Val d'Arno",999,5581,5684,11265
"4364",13157,"Montorfano",999,1211,1324,2535
"4365",67028,"Montorio al Vomano",999,3669,3728,7397
"4366",70047,"Montorio nei Frentani",999,173,181,354
"4367",58066,"Montorio Romano",999,965,955,1920
"4368",64121,"Montoro",999,9683,9706,19389
"4369",24068,"Montorso Vicentino",999,1570,1467,3037
"4370",109027,"Montottone",999,412,471,883
"4371",95085,"Montresta",999,220,223,443
"4372",18100,"Montù Beccaria",999,814,794,1608
"4373",12104,"Monvalle",999,954,987,1941
"4374",108033,"Monza",999,59349,63772,123121
"4375",20036,"Monzambano",999,2381,2422,4803
"4376",37044,"Monzuno",999,3258,3167,6425
"4377",78083,"Morano Calabro",999,1884,1959,3843
"4378",6109,"Morano sul Po",999,618,663,1281
"4379",5122,"Moransengo-Tonengo",999,200,200,400
"4380",31013,"Moraro",999,348,370,718
"4381",12105,"Morazzone",999,2129,2178,4307
"4382",14045,"Morbegno",999,5938,6344,12282
"4383",6110,"Morbello",999,221,178,399
"4384",75050,"Morciano di Leuca",999,1421,1627,3048
"4385",99011,"Morciano di Romagna",999,3488,3683,7171
"4386",62044,"Morcone",999,2193,2312,4505
"4387",37045,"Mordano",999,2332,2255,4587
"4388",16140,"Morengo",999,1238,1243,2481
"4389",90042,"Mores",999,846,850,1696
"4390",109028,"Moresco",999,250,272,522
"4391",4143,"Moretta",999,2027,2058,4085
"4392",33028,"Morfasso",999,446,411,857
"4393",26047,"Morgano",999,2231,2207,4438
"4394",7044,"Morgex",999,998,1059,2057
"4395",95030,"Morgongiori",999,327,318,645
"4396",22123,"Mori",999,5086,5122,10208
"4397",26048,"Moriago della Battaglia",999,1403,1408,2811
"4398",58067,"Moricone",999,1228,1212,2440
"4399",65077,"Morigerati",999,290,307,597
"4400",15150,"Morimondo",999,509,498,1007
"4401",66057,"Morino",999,645,657,1302
"4402",1163,"Moriondo Torinese",999,416,421,837
"4403",58068,"Morlupo",999,4106,4407,8513
"4404",78084,"Mormanno",999,1263,1311,2574
"4405",12106,"Mornago",999,2419,2458,4877
"4406",6111,"Mornese",999,332,344,676
"4407",16141,"Mornico al Serio",999,1462,1497,2959
"4408",18101,"Mornico Losana",999,293,305,598
"4409",60045,"Morolo",999,1592,1564,3156
"4410",4144,"Morozzo",999,1019,994,2013
"4411",64063,"Morra De Sanctis",999,534,580,1114
"4412",42031,"Morro d'Alba",999,900,925,1825
"4413",67029,"Morro d'Oro",999,1735,1802,3537
"4414",70048,"Morrone del Sannio",999,262,252,514
"4415",57045,"Morro Reatino",999,182,158,340
"4416",43033,"Morrovalle",999,4933,4904,9837
"4417",93028,"Morsano al Tagliamento",999,1342,1339,2681
"4418",6112,"Morsasco",999,290,314,604
"4419",18102,"Mortara",999,7563,7937,15500
"4420",30062,"Mortegliano",999,2317,2484,4801
"4421",97055,"Morterone",999,19,15,34
"4422",30063,"Moruzzo",999,1189,1217,2406
"4423",19060,"Moscazzano",999,358,338,696
"4424",64064,"Moschiano",999,753,811,1564
"4425",67030,"Mosciano Sant'Angelo",999,4648,4520,9168
"4426",68025,"Moscufo",999,1567,1505,3072
"4427",21054,"Moso in Passiria/Moos in Passeier",999,1075,946,2021
"4428",31014,"Mossa",999,741,777,1518
"4429",19061,"Motta Baluffi",999,406,389,795
"4430",83058,"Motta Camastra",999,413,383,796
"4431",83059,"Motta d'Affermo",999,324,331,655
"4432",2082,"Motta de' Conti",999,354,358,712
"4433",26049,"Motta di Livenza",999,5242,5460,10702
"4434",78085,"Mottafollone",999,534,538,1072
"4435",96037,"Mottalciata",999,654,643,1297
"4436",71034,"Motta Montecorvino",999,298,332,630
"4437",80054,"Motta San Giovanni",999,2726,2803,5529
"4438",79083,"Motta Santa Lucia",999,399,396,795
"4439",87030,"Motta Sant'Anastasia",999,5949,6111,12060
"4440",15151,"Motta Visconti",999,4044,4150,8194
"4441",20037,"Motteggiana",999,1275,1144,2419
"4442",73019,"Mottola",999,7416,7809,15225
"4443",69056,"Mozzagrogna",999,1179,1248,2427
"4444",16142,"Mozzanica",999,2193,2184,4377
"4445",13159,"Mozzate",999,4301,4434,8735
"4446",23051,"Mozzecane",999,4196,3959,8155
"4447",16143,"Mozzo",999,3550,3713,7263
"4448",43034,"Muccia",999,389,412,801
"4449",32003,"Muggia",999,6234,6605,12839
"4450",108034,"Muggiò",999,11568,12097,23665
"4451",64065,"Mugnano del Cardinale",999,2625,2550,5175
"4452",63048,"Mugnano di Napoli",999,17009,18113,35122
"4453",98041,"Mulazzano",999,2913,2911,5824
"4454",45012,"Mulazzo",999,1155,1137,2292
"4455",17115,"Mura",999,392,387,779
"4456",111042,"Muravera",999,2479,2599,5078
"4457",4145,"Murazzano",999,457,415,872
"4458",4146,"Murello",999,457,468,925
"4459",9040,"Murialdo",999,376,350,726
"4460",6113,"Murisengo",999,626,643,1269
"4461",52019,"Murlo",999,1304,1184,2488
"4462",75051,"Muro Leccese",999,2247,2408,4655
"4463",76053,"Muro Lucano",999,2476,2449,4925
"4464",90043,"Muros",999,400,415,815
"4465",17116,"Muscoline",999,1358,1343,2701
"4466",111043,"Musei",999,771,728,1499
"4467",27025,"Musile di Piave",999,5699,5718,11417
"4468",13160,"Musso",999,476,469,945
"4469",24070,"Mussolente",999,3823,3743,7566
"4470",85012,"Mussomeli",999,4804,5115,9919
"4471",30064,"Muzzana del Turgnano",999,1150,1202,2352
"4472",96038,"Muzzano",999,263,309,572
"4473",22124,"Nago-Torbole",999,1368,1390,2758
"4474",21055,"Nalles/Nals",999,1032,1051,2083
"4475",24071,"Nanto",999,1560,1518,3078
"4476",63049,"Napoli",999,438427,473270,911697
"4477",95031,"Narbolia",999,820,819,1639
"4478",111044,"Narcao",999,1542,1490,3032
"4479",75052,"Nardò",999,14713,16048,30761
"4480",102024,"Nardodipace",999,530,535,1065
"4481",55022,"Narni",999,8642,9262,17904
"4482",84026,"Naro",999,3488,3546,7034
"4483",4147,"Narzole",999,1753,1741,3494
"4484",9041,"Nasino",999,86,78,164
"4485",83060,"Naso",999,1663,1754,3417
"4486",21056,"Naturno/Naturns",999,3041,3045,6086
"4487",17117,"Nave",999,5243,5363,10606
"4488",66058,"Navelli",999,293,273,566
"4489",21057,"Naz-Sciaves/Natz-Schabs",999,1711,1689,3400
"4490",58069,"Nazzano",999,683,658,1341
"4491",10040,"Ne",999,1095,1028,2123
"4492",3103,"Nebbiuno",999,898,940,1838
"4493",23052,"Negrar di Valpolicella",999,8178,8330,16508
"4494",10041,"Neirone",999,467,413,880
"4495",4148,"Neive",999,1572,1663,3235
"4496",16144,"Nembro",999,5569,5659,11228
"4497",58070,"Nemi",999,927,924,1851
"4498",76054,"Nemoli",999,671,704,1375
"4499",95032,"Neoneli",999,288,319,607
"4500",56039,"Nepi",999,4687,4784,9471
"4501",67031,"Nereto",999,2621,2701,5322
"4502",58071,"Nerola",999,929,969,1898
"4503",26050,"Nervesa della Battaglia",999,3256,3262,6518
"4504",15154,"Nerviano",999,8249,8653,16902
"4505",57046,"Nespolo",999,123,76,199
"4506",13161,"Nesso",999,565,572,1137
"4507",96039,"Netro",999,475,462,937
"4508",58072,"Nettuno",999,23925,24372,48297
"4509",75053,"Neviano",999,2359,2513,4872
"4510",34024,"Neviano degli Arduini",999,1747,1703,3450
"4511",4149,"Neviglie",999,184,175,359
"4512",17118,"Niardo",999,952,1013,1965
"4513",3104,"Nibbiola",999,416,412,828
"4514",97056,"Nibionno",999,1777,1791,3568
"4515",1164,"Nichelino",999,22252,23846,46098
"4516",87031,"Nicolosi",999,3772,3834,7606
"4517",18103,"Nicorvo",999,136,140,276
"4518",86012,"Nicosia",999,6094,6495,12589
"4519",102025,"Nicotera",999,3353,3204,6557
"4520",4150,"Niella Belbo",999,168,154,322
"4521",4151,"Niella Tanaro",999,491,448,939
"4522",30065,"Nimis",999,1300,1314,2614
"4523",85013,"Niscemi",999,12249,12561,24810
"4524",86013,"Nissoria",999,1433,1395,2828
"4525",83061,"Nizza di Sicilia",999,1744,1784,3528
"4526",5080,"Nizza Monferrato",999,4863,5193,10056
"4527",27026,"Noale",999,7849,8334,16183
"4528",1165,"Noasca",999,55,51,106
"4529",78086,"Nocara",999,151,157,308
"4530",68026,"Nocciano",999,859,830,1689
"4531",65078,"Nocera Inferiore",999,21307,22501,43808
"4532",65079,"Nocera Superiore",999,11580,12009,23589
"4533",79087,"Nocera Terinese",999,2391,2314,4705
"4534",54034,"Nocera Umbra",999,2751,2775,5526
"4535",34025,"Noceto",999,6512,6788,13300
"4536",72031,"Noci",999,8869,9362,18231
"4537",75054,"Nociglia",999,980,1127,2107
"4538",76055,"Noepoli",999,353,385,738
"4539",23053,"Nogara",999,4092,4208,8300
"4540",22127,"Nogaredo",999,1058,1013,2071
"4541",23054,"Nogarole Rocca",999,2040,1833,3873
"4542",24072,"Nogarole Vicentino",999,627,603,1230
"4543",72032,"Noicattaro",999,12891,13108,25999
"4544",63050,"Nola",999,16417,17367,33784
"4545",1166,"Nole",999,3278,3427,6705
"4546",9042,"Noli",999,1188,1266,2454
"4547",1167,"Nomaglio",999,134,139,273
"4548",22128,"Nomi",999,662,690,1352
"4549",36027,"Nonantola",999,8017,8110,16127
"4550",1168,"None",999,3799,3904,7703
"4551",103048,"Nonio",999,400,427,827
"4552",91050,"Noragugume",999,139,135,274
"4553",95033,"Norbello",999,600,529,1129
"4554",54035,"Norcia",999,2275,2234,4509
"4555",59016,"Norma",999,1771,1898,3669
"4556",15155,"Nosate",999,307,337,644
"4557",67032,"Notaresco",999,3115,3177,6292
"4558",89013,"Noto",999,12405,12167,24572
"4559",99023,"Novafeltria",999,3475,3532,7007
"4560",22129,"Novaledo",999,560,602,1162
"4561",1169,"Novalesa",999,264,253,517
"4562",21058,"Nova Levante/Welschnofen",999,1088,988,2076
"4563",108035,"Nova Milanese",999,11337,11807,23144
"4564",21059,"Nova Ponente/Deutschnofen",999,2080,2001,4081
"4565",3106,"Novara",999,49896,52622,102518
"4566",83062,"Novara di Sicilia",999,552,578,1130
"4567",77018,"Nova Siri",999,3434,3371,6805
"4568",14046,"Novate Mezzola",999,917,979,1896
"4569",15157,"Novate Milanese",999,9622,10464,20086
"4570",24073,"Nove",999,2428,2463,4891
"4571",13163,"Novedrate",999,1466,1427,2893
"4572",22253,"Novella",999,1837,1769,3606
"4573",35028,"Novellara",999,6555,6736,13291
"4574",4152,"Novello",999,460,487,947
"4575",27027,"Noventa di Piave",999,3446,3528,6974
"4576",28058,"Noventa Padovana",999,5596,5804,11400
"4577",24074,"Noventa Vicentina",999,4581,4521,9102
"4578",36028,"Novi di Modena",999,5123,5110,10233
"4579",15158,"Noviglio",999,2284,2252,4536
"4580",6114,"Novi Ligure",999,13176,14167,27343
"4581",65080,"Novi Velia",999,1188,1150,2338
"4582",75055,"Novoli",999,3584,3929,7513
"4583",4153,"Nucetto",999,195,183,378
"4584",90044,"Nughedu San Nicolò",999,369,355,724
"4585",95034,"Nughedu Santa Vittoria",999,203,221,424
"4586",90045,"Nule",999,654,633,1287
"4587",90046,"Nulvi",999,1291,1293,2584
"4588",42032,"Numana",999,1901,1857,3758
"4589",91051,"Nuoro",999,16165,17446,33611
"4590",95035,"Nurachi",999,814,846,1660
"4591",111045,"Nuragus",999,406,410,816
"4592",111046,"Nurallao",999,584,545,1129
"4593",111047,"Nuraminis",999,1158,1164,2322
"4594",95036,"Nureci",999,155,154,309
"4595",111048,"Nurri",999,1015,1000,2015
"4596",7045,"Nus",999,1472,1481,2953
"4597",64066,"Nusco",999,1872,1962,3834
"4598",17119,"Nuvolento",999,1930,1972,3902
"4599",17120,"Nuvolera",999,2364,2401,4765
"4600",111049,"Nuxis",999,685,736,1421
"4601",96040,"Occhieppo Inferiore",999,1780,1968,3748
"4602",96041,"Occhieppo Superiore",999,1234,1344,2578
"4603",29033,"Occhiobello",999,5863,6196,12059
"4604",6115,"Occimiano",999,580,630,1210
"4605",66059,"Ocre",999,557,540,1097
"4606",6116,"Odalengo Grande",999,211,196,407
"4607",6117,"Odalengo Piccolo",999,121,106,227
"4608",26051,"Oderzo",999,9932,10275,20207
"4609",17121,"Odolo",999,930,959,1889
"4610",66060,"Ofena",999,224,211,435
"4611",42033,"Offagna",999,1059,1029,2088
"4612",19062,"Offanengo",999,2966,3005,5971
"4613",44054,"Offida",999,2237,2370,4607
"4614",17122,"Offlaga",999,2107,2016,4123
"4615",103049,"Oggebbio",999,407,431,838
"4616",12107,"Oggiona con Santo Stefano",999,2156,2180,4336
"4617",97057,"Oggiono",999,4557,4592,9149
"4618",1170,"Oglianico",999,701,742,1443
"4619",65081,"Ogliastro Cilento",999,1142,1131,2273
"4620",90047,"Olbia",999,30363,31132,61495
"4621",2088,"Olcenengo",999,387,397,784
"4622",2089,"Oldenico",999,116,115,231
"4623",3108,"Oleggio",999,7017,7232,14249
"4624",3109,"Oleggio Castello",999,1118,1090,2208
"4625",18104,"Olevano di Lomellina",999,342,356,698
"4626",58073,"Olevano Romano",999,3169,3205,6374
"4627",65082,"Olevano sul Tusciano",999,3263,3296,6559
"4628",13165,"Olgiate Comasco",999,5915,6073,11988
"4629",97058,"Olgiate Molgora",999,3138,3156,6294
"4630",12108,"Olgiate Olona",999,6231,6520,12751
"4631",97059,"Olginate",999,3419,3512,6931
"4632",91055,"Oliena",999,3211,3311,6522
"4633",79088,"Olivadi",999,241,246,487
"4634",18105,"Oliva Gessi",999,77,83,160
"4635",83063,"Oliveri",999,1084,1103,2187
"4636",65083,"Oliveto Citra",999,1778,1842,3620
"4637",97060,"Oliveto Lario",999,593,577,1170
"4638",77019,"Oliveto Lucano",999,170,176,346
"4639",8038,"Olivetta San Michele",999,98,99,197
"4640",6118,"Olivola",999,51,58,109
"4641",95037,"Ollastra",999,556,550,1106
"4642",91056,"Ollolai",999,570,592,1162
"4643",7046,"Ollomont",999,85,80,165
"4644",90048,"Olmedo",999,2120,2081,4201
"4645",19063,"Olmeneta",999,430,472,902
"4646",16145,"Olmo al Brembo",999,242,231,473
"4647",5081,"Olmo Gentile",999,33,33,66
"4648",16146,"Oltre il Colle",999,497,451,948
"4649",16147,"Oltressenda Alta",999,71,65,136
"4650",13169,"Oltrona di San Mamette",999,1170,1196,2366
"4651",91057,"Olzai",999,380,375,755
"4652",17123,"Ome",999,1545,1611,3156
"4653",103050,"Omegna",999,6900,7346,14246
"4654",65084,"Omignano",999,818,821,1639
"4655",91058,"Onanì",999,170,184,354
"4656",56040,"Onano",999,427,457,884
"4657",4154,"Oncino",999,49,37,86
"4658",16148,"Oneta",999,275,283,558
"4659",91059,"Onifai",999,346,376,722
"4660",91060,"Oniferi",999,431,421,852
"4661",16149,"Onore",999,452,485,937
"4662",17124,"Ono San Pietro",999,469,484,953
"4663",9043,"Onzo",999,100,116,216
"4664",15159,"Opera",999,6883,7493,14376
"4665",66061,"Opi",999,197,182,379
"4666",23055,"Oppeano",999,5268,5120,10388
"4667",76056,"Oppido Lucano",999,1741,1772,3513
"4668",80055,"Oppido Mamertina",999,2331,2409,4740
"4669",21060,"Ora/Auer",999,1899,1958,3857
"4670",91061,"Orani",999,1327,1333,2660
"4671",70049,"Oratino",999,890,822,1712
"4672",1171,"Orbassano",999,11117,11908,23025
"4673",53018,"Orbetello",999,6770,7416,14186
"4674",50023,"Orciano Pisano",999,304,335,639
"4675",9044,"Orco Feglino",999,477,443,920
"4676",71063,"Ordona",999,1566,1497,3063
"4677",10042,"Orero",999,247,244,491
"4678",24075,"Orgiano",999,1484,1530,3014
"4679",91062,"Orgosolo",999,1949,1952,3901
"4680",74011,"Oria",999,6976,7465,14441
"4681",66062,"Oricola",999,641,637,1278
"4682",12109,"Origgio",999,4019,3981,8000
"4683",12110,"Orino",999,426,407,833
"4684",16150,"Orio al Serio",999,833,804,1637
"4685",1172,"Orio Canavese",999,380,363,743
"4686",98042,"Orio Litta",999,1008,1030,2038
"4687",78087,"Oriolo",999,851,964,1815
"4688",56041,"Oriolo Romano",999,1835,1876,3711
"4689",95038,"Oristano",999,14255,16018,30273
"4690",4155,"Ormea",999,762,703,1465
"4691",26052,"Ormelle",999,2246,2228,4474
"4692",108036,"Ornago",999,2676,2729,5405
"4693",103051,"Ornavasso",999,1657,1652,3309
"4694",16151,"Ornica",999,71,62,133
"4695",91063,"Orosei",999,3395,3422,6817
"4696",91064,"Orotelli",999,926,939,1865
"4697",65085,"Orria",999,471,483,954
"4698",111050,"Orroli",999,991,958,1949
"4699",26053,"Orsago",999,1868,1925,3793
"4700",6119,"Orsara Bormida",999,195,192,387
"4701",71035,"Orsara di Puglia",999,1257,1236,2493
"4702",13170,"Orsenigo",999,1314,1329,2643
"4703",69057,"Orsogna",999,1766,1886,3652
"4704",78088,"Orsomarso",999,551,539,1090
"4705",111051,"Ortacesus",999,458,417,875
"4706",61053,"Orta di Atella",999,13561,13771,27332
"4707",71036,"Orta Nova",999,8272,8369,16641
"4708",3112,"Orta San Giulio",999,516,595,1111
"4709",56042,"Orte",999,4542,4555,9097
"4710",75056,"Ortelle",999,1027,1150,2177
"4711",109029,"Ortezzano",999,365,374,739
"4712",51027,"Ortignano Raggiolo",999,427,410,837
"4713",21061,"Ortisei/St. Ulrich",999,2361,2403,4764
"4714",69058,"Ortona",999,10756,11345,22101
"4715",66063,"Ortona dei Marsi",999,179,207,386
"4716",9045,"Ortovero",999,840,854,1694
"4717",66064,"Ortucchio",999,870,860,1730
"4718",91066,"Ortueri",999,508,493,1001
"4719",91067,"Orune",999,1057,1048,2105
"4720",55023,"Orvieto",999,9167,10200,19367
"4721",57047,"Orvinio",999,207,185,392
"4722",17125,"Orzinuovi",999,6267,6203,12470
"4723",17126,"Orzivecchi",999,1272,1237,2509
"4724",1173,"Osasco",999,573,584,1157
"4725",1174,"Osasio",999,480,443,923
"4726",90049,"Oschiri",999,1505,1464,2969
"4727",91068,"Osidda",999,105,120,225
"4728",9046,"Osiglia",999,218,210,428
"4729",90050,"Osilo",999,1359,1429,2788
"4730",42034,"Osimo",999,17195,17649,34844
"4731",91069,"Osini",999,367,341,708
"4732",16152,"Osio Sopra",999,2578,2590,5168
"4733",16153,"Osio Sotto",999,6421,6295,12716
"4734",97061,"Osnago",999,2290,2446,4736
"4735",30066,"Osoppo",999,1390,1391,2781
"4736",8039,"Ospedaletti",999,1510,1664,3174
"4737",22130,"Ospedaletto",999,419,389,808
"4738",64067,"Ospedaletto d'Alpinolo",999,976,1020,1996
"4739",28059,"Ospedaletto Euganeo",999,2754,2816,5570
"4740",98043,"Ospedaletto Lodigiano",999,1041,951,1992
"4741",25035,"Ospitale di Cadore",999,135,131,266
"4742",17127,"Ospitaletto",999,7618,7287,14905
"4743",98044,"Ossago Lodigiano",999,722,697,1419
"4744",22131,"Ossana",999,405,428,833
"4745",90051,"Ossi",999,2687,2758,5445
"4746",17128,"Ossimo",999,731,722,1453
"4747",15164,"Ossona",999,2178,2141,4319
"4748",4156,"Ostana",999,50,38,88
"4749",38017,"Ostellato",999,2766,2824,5590
"4750",19064,"Ostiano",999,1375,1393,2768
"4751",20038,"Ostiglia",999,3335,3355,6690
"4752",42035,"Ostra",999,3063,3204,6267
"4753",42036,"Ostra Vetere",999,1553,1542,3095
"4754",74012,"Ostuni",999,14365,15543,29908
"4755",75057,"Otranto",999,2690,2920,5610
"4756",55024,"Otricoli",999,824,867,1691
"4757",91070,"Ottana",999,1073,1098,2171
"4758",65086,"Ottati",999,291,289,580
"4759",63051,"Ottaviano",999,11583,11705,23288
"4760",6120,"Ottiglio",999,290,274,564
"4761",18106,"Ottobiano",999,528,544,1072
"4762",33030,"Ottone",999,241,181,422
"4763",1175,"Oulx",999,1673,1610,3283
"4764",6121,"Ovada",999,5223,5632,10855
"4765",30067,"Ovaro",999,865,859,1724
"4766",6122,"Oviglio",999,612,598,1210
"4767",66065,"Ovindoli",999,592,572,1164
"4768",91071,"Ovodda",999,755,729,1484
"4769",7047,"Oyace",999,106,96,202
"4770",1176,"Ozegna",999,595,604,1199
"4771",90052,"Ozieri",999,4864,4911,9775
"4772",37046,"Ozzano dell'Emilia",999,6893,7170,14063
"4773",6123,"Ozzano Monferrato",999,685,666,1351
"4774",15165,"Ozzero",999,696,721,1417
"4775",111052,"Pabillonis",999,1242,1205,2447
"4776",81013,"Paceco",999,5176,5500,10676
"4777",83064,"Pace del Mela",999,2930,3026,5956
"4778",66066,"Pacentro",999,551,528,1079
"4779",89014,"Pachino",999,11191,10635,21826
"4780",54036,"Paciano",999,466,476,942
"4781",17129,"Padenghe sul Garda",999,2354,2525,4879
"4782",6124,"Paderna",999,93,93,186
"4783",97062,"Paderno d'Adda",999,1908,1965,3873
"4784",15166,"Paderno Dugnano",999,23103,24300,47403
"4785",17130,"Paderno Franciacorta",999,1833,1845,3678
"4786",19065,"Paderno Ponchielli",999,675,636,1311
"4787",28060,"Padova",999,99309,107992,207301
"4788",90053,"Padria",999,294,288,582
"4789",90090,"Padru",999,1062,1036,2098
"4790",65087,"Padula",999,2342,2463,4805
"4791",62045,"Paduli",999,1782,1801,3583
"4792",4157,"Paesana",999,1306,1306,2612
"4793",26055,"Paese",999,10969,11178,22147
"4794",65088,"Pagani",999,16657,17424,34081
"4795",57048,"Paganico Sabino",999,84,72,156
"4796",16154,"Pagazzano",999,1105,1025,2130
"4797",83065,"Pagliara",999,545,571,1116
"4798",69059,"Paglieta",999,2073,2088,4161
"4799",30068,"Pagnacco",999,2481,2586,5067
"4800",4158,"Pagno",999,287,292,579
"4801",97063,"Pagnona",999,161,156,317
"4802",64068,"Pago del Vallo di Lauro",999,832,872,1704
"4803",62046,"Pago Veiano",999,1107,1108,2215
"4804",17131,"Paisco Loveno",999,87,80,167
"4805",17132,"Paitone",999,1128,1063,2191
"4806",16155,"Paladina",999,1964,1981,3945
"4807",36029,"Palagano",999,1010,1026,2036
"4808",73020,"Palagianello",999,3667,3875,7542
"4809",73021,"Palagiano",999,7885,7841,15726
"4810",87032,"Palagonia",999,7712,7938,15650
"4811",50024,"Palaia",999,2170,2394,4564
"4812",34026,"Palanzano",999,537,478,1015
"4813",70050,"Palata",999,736,764,1500
"4814",90054,"Palau",999,2082,2018,4100
"4815",16156,"Palazzago",999,2301,2254,4555
"4816",82052,"Palazzo Adriano",999,850,913,1763
"4817",1177,"Palazzo Canavese",999,403,432,835
"4818",89015,"Palazzolo Acreide",999,3917,4132,8049
"4819",30069,"Palazzolo dello Stella",999,1381,1433,2814
"4820",17133,"Palazzolo sull'Oglio",999,10205,10059,20264
"4821",2090,"Palazzolo Vercellese",999,545,552,1097
"4822",19066,"Palazzo Pignano",999,1922,1891,3813
"4823",76057,"Palazzo San Gervasio",999,2210,2161,4371
"4824",48031,"Palazzuolo sul Senio",999,545,536,1081
"4825",69060,"Palena",999,614,602,1216
"4826",79089,"Palermiti",999,501,528,1029
"4827",82053,"Palermo",999,300625,328269,628894
"4828",58074,"Palestrina",999,10886,11272,22158
"4829",18107,"Palestro",999,909,907,1816
"4830",60046,"Paliano",999,3924,3956,7880
"4831",80056,"Palizzi",999,894,960,1854
"4832",101016,"Pallagorio",999,469,478,947
"4833",103052,"Pallanzeno",999,553,538,1091
"4834",9047,"Pallare",999,419,432,851
"4835",63052,"Palma Campania",999,8438,7794,16232
"4836",84027,"Palma di Montechiaro",999,10227,11109,21336
"4837",30070,"Palmanova",999,2585,2749,5334
"4838",75058,"Palmariggi",999,661,693,1354
"4839",95039,"Palmas Arborea",999,740,761,1501
"4840",80057,"Palmi",999,8789,9310,18099
"4841",44056,"Palmiano",999,70,88,158
"4842",69061,"Palmoli",999,435,380,815
"4843",72033,"Palo del Colle",999,10073,10346,20419
"4844",58075,"Palombara Sabina",999,6494,6503,12997
"4845",69062,"Palombaro",999,468,478,946
"4846",65089,"Palomonte",999,1868,1841,3709
"4847",16157,"Palosco",999,2853,2866,5719
"4848",23056,"Palù",999,605,590,1195
"4849",22133,"Palù del Fersina",999,81,78,159
"4850",78089,"Paludi",999,491,471,962
"4851",30071,"Paluzza",999,967,985,1952
"4852",4159,"Pamparato",999,141,114,255
"4853",1178,"Pancalieri",999,956,1019,1975
"4854",18108,"Pancarana",999,164,159,323
"4855",22134,"Panchià",999,394,420,814
"4856",19067,"Pandino",999,4435,4481,8916
"4857",78090,"Panettieri",999,152,158,310
"4858",54037,"Panicale",999,2579,2742,5321
"4859",62047,"Pannarano",999,1036,948,1984
"4860",71037,"Panni",999,323,360,683
"4861",81014,"Pantelleria",999,3653,3629,7282
"4862",15167,"Pantigliate",999,2812,2991,5803
"4863",78091,"Paola",999,7149,7642,14791
"4864",62048,"Paolisi",999,992,962,1954
"4865",78092,"Papasidero",999,309,295,604
"4866",29034,"Papozze",999,683,706,1389
"4867",15168,"Parabiago",999,13851,14310,28161
"4868",75059,"Parabita",999,4121,4557,8678
"4869",17134,"Paratico",999,2493,2504,4997
"4870",21062,"Parcines/Partschins",999,1954,2001,3955
"4871",1179,"Parella",999,206,218,424
"4872",78093,"Parenti",999,982,994,1976
"4873",61054,"Parete",999,6313,6395,12708
"4874",6125,"Pareto",999,277,236,513
"4875",102026,"Parghelia",999,628,664,1292
"4876",97064,"Parlasco",999,71,67,138
"4877",34027,"Parma",999,96420,102076,198496
"4878",6126,"Parodi Ligure",999,311,276,587
"4879",4160,"Paroldo",999,87,91,178
"4880",64069,"Parolise",999,310,317,627
"4881",18109,"Parona",999,935,915,1850
"4882",55025,"Parrano",999,241,237,478
"4883",16158,"Parre",999,1339,1343,2682
"4884",81015,"Partanna",999,4837,4985,9822
"4885",82054,"Partinico",999,15300,15446,30746
"4886",3114,"Paruzzaro",999,1034,1111,2145
"4887",16159,"Parzanica",999,181,158,339
"4888",30072,"Pasian di Prato",999,4464,4777,9241
"4889",93029,"Pasiano di Pordenone",999,3949,3942,7891
"4890",17135,"Paspardo",999,297,281,578
"4891",5082,"Passerano Marmorito",999,249,200,449
"4892",54038,"Passignano sul Trasimeno",999,2742,2958,5700
"4893",17136,"Passirano",999,3382,3508,6890
"4894",60047,"Pastena",999,635,628,1263
"4895",61055,"Pastorano",999,1451,1428,2879
"4896",23057,"Pastrengo",999,1515,1512,3027
"4897",6127,"Pasturana",999,606,662,1268
"4898",97065,"Pasturo",999,996,967,1963
"4899",76100,"Paterno",999,1437,1552,2989
"4900",87033,"Paternò",999,21898,23072,44970
"4901",78094,"Paterno Calabro",999,688,643,1331
"4902",64070,"Paternopoli",999,1051,1054,2105
"4903",60048,"Patrica",999,1540,1524,3064
"4904",90055,"Pattada",999,1439,1388,2827
"4905",83066,"Patti",999,6057,6642,12699
"4906",75060,"Patù",999,809,845,1654
"4907",95040,"Pau",999,129,141,270
"4908",30073,"Paularo",999,1177,1163,2340
"4909",111053,"Pauli Arbarei",999,270,276,546
"4910",95041,"Paulilatino",999,1071,1031,2102
"4911",15169,"Paullo",999,5494,5634,11128
"4912",62049,"Paupisi",999,712,717,1429
"4913",1180,"Pavarolo",999,579,586,1165
"4914",18110,"Pavia",999,34287,37096,71383
"4915",30074,"Pavia di Udine",999,2719,2761,5480
"4916",1181,"Pavone Canavese",999,1748,1841,3589
"4917",17137,"Pavone del Mella",999,1383,1347,2730
"4918",36030,"Pavullo nel Frignano",999,9086,9147,18233
"4919",80058,"Pazzano",999,243,243,486
"4920",50025,"Peccioli",999,2268,2425,4693
"4921",6128,"Pecetto di Valenza",999,577,592,1169
"4922",1183,"Pecetto Torinese",999,1972,2049,4021
"4923",87034,"Pedara",999,7542,7624,15166
"4924",109030,"Pedaso",999,1365,1494,2859
"4925",25036,"Pedavena",999,2124,2202,4326
"4926",24076,"Pedemonte",999,328,336,664
"4927",26056,"Pederobba",999,3692,3662,7354
"4928",14047,"Pedesina",999,18,17,35
"4929",78096,"Pedivigliano",999,341,386,727
"4930",16160,"Pedrengo",999,2935,2967,5902
"4931",41041,"Peglio",999,318,327,645
"4932",13178,"Peglio",999,95,97,192
"4933",20039,"Pegognaga",999,3403,3473,6876
"4934",16161,"Peia",999,820,877,1697
"4935",22136,"Peio",999,935,859,1794
"4936",48032,"Pelago",999,3897,3962,7859
"4937",3115,"Pella",999,411,459,870
"4938",34028,"Pellegrino Parmense",999,490,477,967
"4939",65090,"Pellezzano",999,5386,5508,10894
"4940",22137,"Pellizzano",999,385,415,800
"4941",22138,"Pelugo",999,190,207,397
"4942",5083,"Penango",999,221,219,440
"4943",99024,"Pennabilli",999,1306,1332,2638
"4944",69063,"Pennadomo",999,99,108,207
"4945",55026,"Penna in Teverina",999,493,507,1000
"4946",69064,"Pennapiedimonte",999,195,204,399
"4947",43035,"Penna San Giovanni",999,447,480,927
"4948",67033,"Penna Sant'Andrea",999,831,831,1662
"4949",68027,"Penne",999,5481,5666,11147
"4950",79092,"Pentone",999,894,947,1841
"4951",69065,"Perano",999,720,759,1479
"4952",25037,"Perarolo di Cadore",999,180,183,363
"4953",21063,"Perca/Percha",999,865,845,1710
"4954",58076,"Percile",999,114,107,221
"4955",91072,"Perdasdefogu",999,862,854,1716
"4956",111054,"Perdaxius",999,653,645,1298
"4957",65091,"Perdifumo",999,883,926,1809
"4958",66067,"Pereto",999,326,311,637
"4959",90056,"Perfugas",999,1122,1127,2249
"4960",22139,"Pergine Valsugana",999,10579,11105,21684
"4961",41043,"Pergola",999,2821,2941,5762
"4962",8040,"Perinaldo",999,405,402,807
"4963",65092,"Perito",999,399,403,802
"4964",97067,"Perledo",999,411,428,839
"4965",4161,"Perletto",999,132,121,253
"4966",4162,"Perlo",999,62,45,107
"4967",7048,"Perloz",999,217,229,446
"4968",28061,"Pernumia",999,1888,1866,3754
"4969",15170,"Pero",999,5872,5902,11774
"4970",1184,"Perosa Argentina",999,1454,1616,3070
"4971",1185,"Perosa Canavese",999,242,261,503
"4972",1186,"Perrero",999,302,255,557
"4973",19068,"Persico Dosimo",999,1628,1641,3269
"4974",2091,"Pertengo",999,157,167,324
"4975",17139,"Pertica Alta",999,288,266,554
"4976",17140,"Pertica Bassa",999,282,285,567
"4977",65093,"Pertosa",999,326,330,656
"4978",1187,"Pertusio",999,362,372,734
"4979",54039,"Perugia",999,78177,84350,162527
"4980",41044,"Pesaro",999,46049,49531,95580
"4981",46022,"Pescaglia",999,1636,1638,3274
"4982",23058,"Pescantina",999,8702,8819,17521
"4983",68028,"Pescara",999,56136,62498,118634
"4984",19069,"Pescarolo ed Uniti",999,767,754,1521
"4985",66068,"Pescasseroli",999,1088,995,2083
"4986",97068,"Pescate",999,1080,1080,2160
"4987",94031,"Pesche",999,737,735,1472
"4988",71038,"Peschici",999,2138,2156,4294
"4989",15171,"Peschiera Borromeo",999,11976,12434,24410
"4990",23059,"Peschiera del Garda",999,5294,5713,11007
"4991",47012,"Pescia",999,9344,9909,19253
"4992",66069,"Pescina",999,1825,1843,3668
"4993",66070,"Pescocostanzo",999,563,523,1086
"4994",94032,"Pescolanciano",999,397,392,789
"4995",76058,"Pescopagano",999,813,830,1643
"4996",94033,"Pescopennataro",999,121,113,234
"4997",57049,"Pescorocchiano",999,937,890,1827
"4998",62050,"Pesco Sannita",999,888,947,1835
"4999",68029,"Pescosansonesco",999,216,230,446
"5000",60049,"Pescosolido",999,710,691,1401
"5001",15172,"Pessano con Bornago",999,4440,4534,8974
"5002",19070,"Pessina Cremonese",999,290,269,559
"5003",1188,"Pessinetto",999,305,288,593
"5004",70051,"Petacciato",999,1750,1738,3488
"5005",101017,"Petilia Policastro",999,4282,4293,8575
"5006",65094,"Petina",999,495,497,992
"5007",82055,"Petralia Soprana",999,1424,1484,2908
"5008",82056,"Petralia Sottana",999,1133,1282,2415
"5009",57050,"Petrella Salto",999,561,466,1027
"5010",70052,"Petrella Tifernina",999,500,529,1029
"5011",41045,"Petriano",999,1429,1404,2833
"5012",43036,"Petriolo",999,916,911,1827
"5013",109031,"Petritoli",999,1061,1100,2161
"5014",79094,"Petrizzi",999,499,505,1004
"5015",79095,"Petronà",999,1141,1206,2347
"5016",81024,"Petrosino",999,4064,3843,7907
"5017",64071,"Petruro Irpino",999,156,142,298
"5018",3116,"Pettenasco",999,643,661,1304
"5019",96042,"Pettinengo",999,728,724,1452
"5020",83067,"Pettineo",999,611,630,1241
"5021",94034,"Pettoranello del Molise",999,247,198,445
"5022",66071,"Pettorano sul Gizio",999,682,621,1303
"5023",29035,"Pettorazza Grimani",999,725,705,1430
"5024",4163,"Peveragno",999,2713,2781,5494
"5025",2093,"Pezzana",999,633,653,1286
"5026",17141,"Pezzaze",999,739,702,1441
"5027",4164,"Pezzolo Valle Uzzone",999,143,155,298
"5028",33032,"Piacenza",999,49969,53152,103121
"5029",28062,"Piacenza d'Adige",999,615,618,1233
"5030",19116,"Piadena Drizzona",999,2000,2002,4002
"5031",65095,"Piaggine",999,539,575,1114
"5032",9048,"Piana Crixia",999,369,364,733
"5033",82057,"Piana degli Albanesi",999,2713,2738,5451
"5034",61056,"Piana di Monte Verna",999,989,1058,2047
"5035",17142,"Pian Camuno",999,2437,2348,4785
"5036",52020,"Piancastagnaio",999,1867,1992,3859
"5037",17206,"Piancogno",999,2411,2365,4776
"5038",41047,"Piandimeleto",999,1021,996,2017
"5039",78097,"Piane Crati",999,653,683,1336
"5040",68030,"Pianella",999,4255,4247,8502
"5041",13183,"Pianello del Lario",999,536,547,1083
"5042",33033,"Pianello Val Tidone",999,1061,1112,2173
"5043",19072,"Pianengo",999,1283,1248,2531
"5044",1189,"Pianezza",999,7544,7941,15485
"5045",24077,"Pianezze",999,1092,1103,2195
"5046",4165,"Pianfei",999,1067,1027,2094
"5047",16162,"Pianico",999,723,716,1439
"5048",27028,"Pianiga",999,6033,6175,12208
"5049",63053,"Piano di Sorrento",999,5929,6373,12302
"5050",79096,"Pianopoli",999,1269,1280,2549
"5051",37047,"Pianoro",999,8696,9039,17735
"5052",56043,"Piansano",999,1041,962,2003
"5053",14048,"Piantedo",999,715,727,1442
"5054",16163,"Piario",999,507,488,995
"5055",4166,"Piasco",999,1386,1375,2761
"5056",14049,"Piateda",999,999,1065,2064
"5057",96043,"Piatto",999,237,235,472
"5058",46023,"Piazza al Serchio",999,999,1087,2086
"5059",86014,"Piazza Armerina",999,10204,10505,20709
"5060",16164,"Piazza Brembana",999,576,610,1186
"5061",16165,"Piazzatorre",999,194,199,393
"5062",28063,"Piazzola sul Brenta",999,5523,5600,11123
"5063",16166,"Piazzolo",999,41,44,85
"5064",68031,"Picciano",999,623,643,1266
"5065",76059,"Picerno",999,2802,2805,5607
"5066",60050,"Picinisco",999,539,559,1098
"5067",60051,"Pico",999,1286,1335,2621
"5068",5084,"Piea",999,252,257,509
"5069",96044,"Piedicavallo",999,91,78,169
"5070",87035,"Piedimonte Etneo",999,1935,1965,3900
"5071",61057,"Piedimonte Matese",999,4839,5221,10060
"5072",60052,"Piedimonte San Germano",999,3145,3159,6304
"5073",103053,"Piedimulera",999,734,709,1443
"5074",54040,"Piegaro",999,1627,1729,3356
"5075",52021,"Pienza",999,927,1039,1966
"5076",19073,"Pieranica",999,557,550,1107
"5077",94035,"Pietrabbondante",999,309,288,597
"5078",8041,"Pietrabruna",999,210,204,414
"5079",67034,"Pietracamela",999,118,86,204
"5080",70053,"Pietracatella",999,614,620,1234
"5081",70054,"Pietracupa",999,100,106,206
"5082",64072,"Pietradefusi",999,993,955,1948
"5083",18111,"Pietra de' Giorgi",999,377,379,756
"5084",69103,"Pietraferrazzana",999,62,68,130
"5085",78098,"Pietrafitta",999,570,588,1158
"5086",76060,"Pietragalla",999,1902,1908,3810
"5087",9049,"Pietra Ligure",999,3929,4349,8278
"5088",54041,"Pietralunga",999,976,1001,1977
"5089",6129,"Pietra Marazzi",999,425,453,878
"5090",61058,"Pietramelara",999,2152,2281,4433
"5091",71039,"Pietramontecorvino",999,1189,1271,2460
"5092",68032,"Pietranico",999,208,219,427
"5093",78099,"Pietrapaola",999,492,532,1024
"5094",76061,"Pietrapertosa",999,424,450,874
"5095",86015,"Pietraperzia",999,2986,3318,6304
"5096",4167,"Pietraporzio",999,34,34,68
"5097",62051,"Pietraroja",999,228,266,494
"5098",41048,"Pietrarubbia",999,302,281,583
"5099",46024,"Pietrasanta",999,10769,12066,22835
"5100",64073,"Pietrastornina",999,726,701,1427
"5101",61059,"Pietravairano",999,1386,1414,2800
"5102",62052,"Pietrelcina",999,1460,1426,2886
"5103",18112,"Pieve Albignola",999,404,405,809
"5104",47013,"Pieve a Nievole",999,4424,4707,9131
"5105",18113,"Pieve del Cairo",999,859,901,1760
"5106",26096,"Pieve del Grappa",999,3251,3405,6656
"5107",22234,"Pieve di Bono-Prezzo",999,728,728,1456
"5108",25039,"Pieve di Cadore",999,1732,1848,3580
"5109",37048,"Pieve di Cento",999,3649,3684,7333
"5110",26057,"Pieve di Soligo",999,5712,5883,11595
"5111",8042,"Pieve di Teco",999,641,666,1307
"5112",19074,"Pieve d'Olmi",999,613,612,1225
"5113",15173,"Pieve Emanuele",999,7888,7819,15707
"5114",98045,"Pieve Fissiraga",999,870,881,1751
"5115",46025,"Pieve Fosciana",999,1114,1113,2227
"5116",10043,"Pieve Ligure",999,1187,1216,2403
"5117",36031,"Pievepelago",999,1064,1052,2116
"5118",18114,"Pieve Porto Morone",999,1330,1275,2605
"5119",19075,"Pieve San Giacomo",999,820,815,1635
"5120",51030,"Pieve Santo Stefano",999,1469,1505,2974
"5121",22142,"Pieve Tesino",999,330,324,654
"5122",43038,"Pieve Torina",999,612,614,1226
"5123",103054,"Pieve Vergonte",999,1169,1240,2409
"5124",60053,"Piglio",999,2147,2179,4326
"5125",8043,"Pigna",999,370,371,741
"5126",60054,"Pignataro Interamna",999,1213,1216,2429
"5127",61060,"Pignataro Maggiore",999,2835,2892,5727
"5128",76062,"Pignola",999,3382,3425,6807
"5129",11021,"Pignone",999,264,261,525
"5130",13184,"Pigra",999,123,117,240
"5131",2096,"Pila",999,76,63,139
"5132",111055,"Pimentel",999,565,537,1102
"5133",63054,"Pimonte",999,2932,2930,5862
"5134",18115,"Pinarolo Po",999,808,859,1667
"5135",1190,"Pinasca",999,1345,1439,2784
"5136",29036,"Pincara",999,544,536,1080
"5137",1191,"Pinerolo",999,16916,18553,35469
"5138",67035,"Pineto",999,7058,7640,14698
"5139",5085,"Pino d'Asti",999,124,101,225
"5140",1192,"Pino Torinese",999,4072,4373,8445
"5141",93030,"Pinzano al Tagliamento",999,745,771,1516
"5142",22143,"Pinzolo",999,1481,1558,3039
"5143",41049,"Piobbico",999,891,916,1807
"5144",4168,"Piobesi d'Alba",999,732,712,1444
"5145",1193,"Piobesi Torinese",999,1825,1931,3756
"5146",2097,"Piode",999,95,93,188
"5147",15175,"Pioltello",999,18569,18088,36657
"5148",49012,"Piombino",999,15777,16666,32443
"5149",28064,"Piombino Dese",999,4780,4690,9470
"5150",43039,"Pioraco",999,484,473,957
"5151",1194,"Piossasco",999,8810,9190,18000
"5152",5086,"Piovà Massaia",999,273,302,575
"5153",28065,"Piove di Sacco",999,9766,10400,20166
"5154",24078,"Piovene Rocchette",999,4115,4152,8267
"5155",33034,"Piozzano",999,314,265,579
"5156",4169,"Piozzo",999,496,488,984
"5157",83068,"Piraino",999,1870,1927,3797
"5158",50026,"Pisa",999,43067,46304,89371
"5159",3119,"Pisano",999,384,411,795
"5160",1195,"Piscina",999,1600,1673,3273
"5161",111056,"Piscinas",999,371,401,772
"5162",65096,"Pisciotta",999,1202,1225,2427
"5163",17143,"Pisogne",999,3902,4000,7902
"5164",58077,"Pisoniano",999,361,368,729
"5165",77020,"Pisticci",999,8513,8398,16911
"5166",47014,"Pistoia",999,42901,46215,89116
"5167",53019,"Pitigliano",999,1687,1861,3548
"5168",20041,"Piubega",999,871,861,1732
"5169",14050,"Piuro",999,947,963,1910
"5170",1196,"Piverone",999,605,667,1272
"5171",18116,"Pizzale",999,343,343,686
"5172",19076,"Pizzighettone",999,3073,3176,6249
"5173",102027,"Pizzo",999,4301,4463,8764
"5174",69066,"Pizzoferrato",999,517,453,970
"5175",66072,"Pizzoli",999,2257,2065,4322
"5176",94036,"Pizzone",999,161,139,300
"5177",102028,"Pizzoni",999,478,487,965
"5178",80059,"Placanica",999,499,515,1014
"5179",78100,"Plataci",999,329,312,641
"5180",79099,"Platania",999,976,980,1956
"5181",80060,"Platì",999,1862,1828,3690
"5182",21064,"Plaus/Plaus",999,386,371,757
"5183",13185,"Plesio",999,429,394,823
"5184",90057,"Ploaghe",999,2108,2147,4255
"5185",9050,"Plodio",999,313,310,623
"5186",4170,"Pocapaglia",999,1619,1692,3311
"5187",30075,"Pocenia",999,1182,1185,2367
"5188",45013,"Podenzana",999,1047,1062,2109
"5189",33035,"Podenzano",999,4482,4621,9103
"5190",60055,"Pofi",999,1920,1953,3873
"5191",75061,"Poggiardo",999,2771,3029,5800
"5192",52022,"Poggibonsi",999,13808,14383,28191
"5193",100004,"Poggio a Caiano",999,4885,5055,9940
"5194",57051,"Poggio Bustone",999,1000,968,1968
"5195",57052,"Poggio Catino",999,624,649,1273
"5196",54042,"Poggiodomo",999,51,40,91
"5197",69067,"Poggiofiorito",999,371,406,777
"5198",71040,"Poggio Imperiale",999,1278,1210,2488
"5199",63055,"Poggiomarino",999,11187,11218,22405
"5200",57053,"Poggio Mirteto",999,3010,3157,6167
"5201",57054,"Poggio Moiano",999,1451,1376,2827
"5202",57055,"Poggio Nativo",999,1361,1210,2571
"5203",66073,"Poggio Picenze",999,476,518,994
"5204",81016,"Poggioreale",999,644,647,1291
"5205",38018,"Poggio Renatico",999,4841,4960,9801
"5206",72034,"Poggiorsini",999,640,623,1263
"5207",20042,"Poggio Rusco",999,3244,3203,6447
"5208",57056,"Poggio San Lorenzo",999,286,264,550
"5209",42037,"Poggio San Marcello",999,366,334,700
"5210",94037,"Poggio Sannita",999,284,279,563
"5211",43040,"Poggio San Vicino",999,101,119,220
"5212",99028,"Poggio Torriana",999,2573,2569,5142
"5213",14051,"Poggiridenti",999,884,939,1823
"5214",15176,"Pogliano Milanese",999,4153,4219,8372
"5215",13186,"Pognana Lario",999,330,328,658
"5216",16167,"Pognano",999,781,767,1548
"5217",3120,"Pogno",999,653,699,1352
"5218",1197,"Poirino",999,5108,5089,10197
"5219",24079,"Pojana Maggiore",999,2146,2112,4258
"5220",17144,"Polaveno",999,1256,1221,2477
"5221",93031,"Polcenigo",999,1522,1588,3110
"5222",29037,"Polesella",999,1809,1800,3609
"5223",34050,"Polesine Zibello",999,1538,1582,3120
"5224",58078,"Poli",999,1090,1112,2202
"5225",102029,"Polia",999,388,419,807
"5226",77021,"Policoro",999,8705,9084,17789
"5227",72035,"Polignano a Mare",999,8551,8913,17464
"5228",36032,"Polinago",999,806,772,1578
"5229",55027,"Polino",999,111,93,204
"5230",80061,"Polistena",999,4794,5107,9901
"5231",82058,"Polizzi Generosa",999,1385,1466,2851
"5232",65097,"Polla",999,2492,2611,5103
"5233",7049,"Pollein",999,745,748,1493
"5234",63056,"Pollena Trocchia",999,6118,6620,12738
"5235",43041,"Pollenza",999,3098,3106,6204
"5236",65098,"Pollica",999,1060,1093,2153
"5237",82059,"Pollina",999,1391,1431,2822
"5238",96046,"Pollone",999,970,1012,1982
"5239",69068,"Pollutri",999,1007,1052,2059
"5240",4171,"Polonghera",999,552,572,1124
"5241",17145,"Polpenazze del Garda",999,1354,1391,2745
"5242",28066,"Polverara",999,1669,1719,3388
"5243",42038,"Polverigi",999,2292,2301,4593
"5244",50027,"Pomarance",999,2590,2695,5285
"5245",1198,"Pomaretto",999,450,520,970
"5246",77022,"Pomarico",999,1868,1894,3762
"5247",22144,"Pomarolo",999,1250,1199,2449
"5248",6131,"Pomaro Monferrato",999,148,154,302
"5249",3121,"Pombia",999,1068,1054,2122
"5250",58079,"Pomezia",999,32299,32318,64617
"5251",63057,"Pomigliano d'Arco",999,19076,20712,39788
"5252",63058,"Pompei",999,11404,12403,23807
"5253",8044,"Pompeiana",999,419,432,851
"5254",17146,"Pompiano",999,1861,1857,3718
"5255",20043,"Pomponesco",999,829,882,1711
"5256",95042,"Pompu",999,118,103,221
"5257",17147,"Poncarale",999,2577,2609,5186
"5258",96047,"Ponderano",999,1756,1913,3669
"5259",13187,"Ponna",999,123,113,236
"5260",50028,"Ponsacco",999,7636,7957,15593
"5261",28067,"Ponso",999,1238,1180,2418
"5262",48033,"Pontassieve",999,9907,10325,20232
"5263",7050,"Pontboset",999,96,75,171
"5264",1199,"Pont Canavese",999,1450,1555,3005
"5265",62053,"Ponte",999,1176,1224,2400
"5266",30076,"Pontebba",999,633,646,1279
"5267",47016,"Ponte Buggianese",999,4297,4488,8785
"5268",65099,"Pontecagnano Faiano",999,13130,13278,26408
"5269",29038,"Pontecchio Polesine",999,1117,1098,2215
"5270",4172,"Pontechianale",999,90,88,178
"5271",60056,"Pontecorvo",999,5939,6259,12198
"5272",6132,"Pontecurone",999,1734,1747,3481
"5273",8045,"Pontedassio",999,1188,1150,2338
"5274",33036,"Ponte dell'Olio",999,2281,2389,4670
"5275",50029,"Pontedera",999,14708,14962,29670
"5276",17148,"Ponte di Legno",999,871,881,1752
"5277",26058,"Ponte di Piave",999,4219,4112,8331
"5278",21065,"Ponte Gardena/Waidbruck",999,119,96,215
"5279",14052,"Ponte in Valtellina",999,1092,1104,2196
"5280",13188,"Ponte Lambro",999,2114,2166,4280
"5281",62054,"Pontelandolfo",999,991,1020,2011
"5282",61061,"Pontelatone",999,751,771,1522
"5283",28068,"Pontelongo",999,1834,1821,3655
"5284",25040,"Ponte nelle Alpi",999,3919,4016,7935
"5285",18117,"Ponte Nizza",999,371,383,754
"5286",16168,"Ponte Nossa",999,842,849,1691
"5287",33037,"Pontenure",999,3250,3393,6643
"5288",16169,"Ponteranica",999,3347,3346,6693
"5289",28069,"Ponte San Nicolò",999,6362,6841,13203
"5290",16170,"Ponte San Pietro",999,5947,5964,11911
"5291",6133,"Pontestura",999,647,682,1329
"5292",17149,"Pontevico",999,3309,3704,7013
"5293",7051,"Pontey",999,397,381,778
"5294",6134,"Ponti",999,253,250,503
"5295",16171,"Pontida",999,1660,1585,3245
"5296",59017,"Pontinia",999,7503,7572,15075
"5297",9051,"Pontinvrea",999,411,386,797
"5298",16172,"Pontirolo Nuovo",999,2484,2429,4913
"5299",20044,"Ponti sul Mincio",999,1152,1190,2342
"5300",17150,"Pontoglio",999,3525,3478,7003
"5301",45014,"Pontremoli",999,3291,3592,6883
"5302",7052,"Pont-Saint-Martin",999,1691,1844,3535
"5303",59018,"Ponza",999,1733,1554,3287
"5304",109032,"Ponzano di Fermo",999,838,790,1628
"5305",6135,"Ponzano Monferrato",999,161,165,326
"5306",58080,"Ponzano Romano",999,669,601,1270
"5307",26059,"Ponzano Veneto",999,6415,6584,12999
"5308",6136,"Ponzone",999,515,487,1002
"5309",68033,"Popoli",999,2253,2421,4674
"5310",51031,"Poppi",999,2963,2865,5828
"5311",55028,"Porano",999,882,970,1852
"5312",46026,"Porcari",999,4370,4466,8836
"5313",93032,"Porcia",999,7241,7704,14945
"5314",93033,"Pordenone",999,25346,26998,52344
"5315",13189,"Porlezza",999,2391,2495,4886
"5316",8046,"Pornassio",999,380,269,649
"5317",30077,"Porpetto",999,1237,1238,2475
"5318",5087,"Portacomaro",999,937,967,1904
"5319",18118,"Portalbera",999,716,754,1470
"5320",1200,"Porte",999,576,550,1126
"5321",22244,"Porte di Rendena",999,917,902,1819
"5322",63059,"Portici",999,24403,27478,51881
"5323",61062,"Portico di Caserta",999,3774,3923,7697
"5324",40031,"Portico e San Benedetto",999,399,358,757
"5325",80062,"Portigliola",999,489,532,1021
"5326",49013,"Porto Azzurro",999,1869,1742,3611
"5327",26060,"Portobuffolè",999,366,375,741
"5328",70055,"Portocannone",999,1181,1139,2320
"5329",12113,"Porto Ceresio",999,1409,1460,2869
"5330",75097,"Porto Cesareo",999,3232,3233,6465
"5331",84028,"Porto Empedocle",999,7623,7961,15584
"5332",49014,"Portoferraio",999,5749,6059,11808
"5333",10044,"Portofino",999,182,179,361
"5334",27029,"Portogruaro",999,11715,12641,24356
"5335",38019,"Portomaggiore",999,6087,5879,11966
"5336",20045,"Porto Mantovano",999,8178,8489,16667
"5337",89020,"Portopalo di Capo Passero",999,1946,1880,3826
"5338",43042,"Porto Recanati",999,6362,6074,12436
"5339",109033,"Porto San Giorgio",999,7379,8238,15617
"5340",109034,"Porto Sant'Elpidio",999,12749,13183,25932
"5341",111057,"Portoscuso",999,2374,2418,4792
"5342",29039,"Porto Tolle",999,4361,4516,8877
"5343",90058,"Porto Torres",999,10285,10735,21020
"5344",12114,"Porto Valtravaglia",999,1080,1191,2271
"5345",11022,"Portovenere",999,1627,1627,3254
"5346",29052,"Porto Viro",999,6747,7010,13757
"5347",96048,"Portula",999,550,563,1113
"5348",91073,"Posada",999,1529,1498,3027
"5349",24080,"Posina",999,295,277,572
"5350",65100,"Positano",999,1821,1898,3719
"5351",26061,"Possagno",999,1184,1112,2296
"5352",57057,"Posta",999,298,257,555
"5353",60057,"Posta Fibreno",999,498,523,1021
"5354",21066,"Postal/Burgstall",999,987,1031,2018
"5355",14053,"Postalesio",999,333,332,665
"5356",65101,"Postiglione",999,991,987,1978
"5357",2102,"Postua",999,270,264,534
"5358",76063,"Potenza",999,30870,33249,64119
"5359",43043,"Potenza Picena",999,7547,7956,15503
"5360",24081,"Pove del Grappa",999,1532,1627,3159
"5361",26062,"Povegliano",999,2534,2545,5079
"5362",23060,"Povegliano Veronese",999,3659,3741,7400
"5363",35029,"Poviglio",999,3544,3553,7097
"5364",30078,"Povoletto",999,2685,2744,5429
"5365",57058,"Pozzaglia Sabina",999,163,145,308
"5366",19077,"Pozzaglio ed Uniti",999,722,713,1435
"5367",88008,"Pozzallo",999,9338,9562,18900
"5368",94038,"Pozzilli",999,1057,1098,2155
"5369",15177,"Pozzo d'Adda",999,3421,3275,6696
"5370",17151,"Pozzolengo",999,1772,1804,3576
"5371",24082,"Pozzoleone",999,1434,1303,2737
"5372",6137,"Pozzol Groppo",999,152,143,295
"5373",6138,"Pozzolo Formigaro",999,2270,2264,4534
"5374",90059,"Pozzomaggiore",999,1161,1174,2335
"5375",28070,"Pozzonovo",999,1665,1738,3403
"5376",63060,"Pozzuoli",999,37020,39191,76211
"5377",30079,"Pozzuolo del Friuli",999,3360,3518,6878
"5378",15178,"Pozzuolo Martesana",999,4223,4390,8613
"5379",16173,"Pradalunga",999,2254,2272,4526
"5380",30080,"Pradamano",999,1694,1842,3536
"5381",4173,"Pradleves",999,126,112,238
"5382",1201,"Pragelato",999,407,337,744
"5383",78101,"Praia a Mare",999,3000,3367,6367
"5384",65102,"Praiano",999,961,1009,1970
"5385",17152,"Pralboino",999,1450,1363,2813
"5386",1202,"Prali",999,137,119,256
"5387",1203,"Pralormo",999,931,958,1889
"5388",96049,"Pralungo",999,1102,1169,2271
"5389",27030,"Pramaggiore",999,2364,2388,4752
"5390",1204,"Pramollo",999,115,106,221
"5391",2104,"Prarolo",999,386,348,734
"5392",1205,"Prarostino",999,640,617,1257
"5393",6139,"Prasco",999,253,243,496
"5394",1206,"Prascorsano",999,360,337,697
"5395",14054,"Prata Camportaccio",999,1467,1458,2925
"5396",66074,"Prata d'Ansidonia",999,224,222,446
"5397",93034,"Prata di Pordenone",999,4177,4127,8304
"5398",64074,"Prata di Principato Ultra",999,1352,1332,2684
"5399",61063,"Prata Sannita",999,655,697,1352
"5400",61064,"Pratella",999,680,704,1384
"5401",1207,"Pratiglione",999,231,228,459
"5402",100005,"Prato",999,97347,100687,198034
"5403",21067,"Prato allo Stelvio/Prad am Stilfserjoch",999,1939,1917,3856
"5404",30081,"Prato Carnico",999,421,404,825
"5405",66075,"Pratola Peligna",999,3440,3569,7009
"5406",64075,"Pratola Serra",999,1762,1803,3565
"5407",3122,"Prato Sesia",999,909,923,1832
"5408",51041,"Pratovecchio Stia",999,2670,2752,5422
"5409",93035,"Pravisdomini",999,1722,1760,3482
"5410",96050,"Pray",999,944,1051,1995
"5411",4174,"Prazzo",999,93,86,179
"5412",30082,"Precenicco",999,710,717,1427
"5413",54043,"Preci",999,354,345,699
"5414",22230,"Predaia",999,3465,3438,6903
"5415",40032,"Predappio",999,3179,3129,6308
"5416",22147,"Predazzo",999,2228,2308,4536
"5417",21068,"Predoi/Prettau",999,261,248,509
"5418",16174,"Predore",999,899,965,1864
"5419",6140,"Predosa",999,928,973,1901
"5420",26063,"Preganziol",999,8306,8502,16808
"5421",15179,"Pregnana Milanese",999,3629,3675,7304
"5422",8047,"Prelà",999,248,231,479
"5423",97069,"Premana",999,1101,1067,2168
"5424",30083,"Premariacco",999,1915,2001,3916
"5425",103055,"Premeno",999,404,370,774
"5426",103056,"Premia",999,267,281,548
"5427",40033,"Premilcuore",999,342,348,690
"5428",16175,"Premolo",999,548,505,1053
"5429",103057,"Premosello-Chiovenda",999,881,964,1845
"5430",30084,"Preone",999,130,124,254
"5431",30085,"Prepotto",999,351,352,703
"5432",7053,"Pré-Saint-Didier",999,507,451,958
"5433",17153,"Preseglie",999,758,699,1457
"5434",61065,"Presenzano",999,827,790,1617
"5435",16176,"Presezzo",999,2340,2427,4767
"5436",75098,"Presicce-Acquarica",999,4424,4791,9215
"5437",23061,"Pressana",999,1295,1182,2477
"5438",69069,"Pretoro",999,419,448,867
"5439",17155,"Prevalle",999,3455,3421,6876
"5440",66076,"Prezza",999,411,436,847
"5441",4175,"Priero",999,245,231,476
"5442",65103,"Prignano Cilento",999,546,549,1095
"5443",36033,"Prignano sulla Secchia",999,1947,1869,3816
"5444",97070,"Primaluna",999,1125,1143,2268
"5445",22245,"Primiero San Martino di Castrozza",999,2457,2526,4983
"5446",4176,"Priocca",999,1026,1050,2076
"5447",4177,"Priola",999,309,318,627
"5448",89021,"Priolo Gargallo",999,5503,5695,11198
"5449",59019,"Priverno",999,6808,6986,13794
"5450",82060,"Prizzi",999,1965,2118,4083
"5451",56044,"Proceno",999,290,246,536
"5452",63061,"Procida",999,4967,5077,10044
"5453",10045,"Propata",999,67,46,113
"5454",13192,"Proserpio",999,477,481,958
"5455",59020,"Prossedi",999,581,565,1146
"5456",17156,"Provaglio d'Iseo",999,3481,3602,7083
"5457",17157,"Provaglio Val Sabbia",999,445,415,860
"5458",21069,"Proves/Proveis",999,143,106,249
"5459",70056,"Provvidenti",999,50,49,99
"5460",4178,"Prunetto",999,200,193,393
"5461",17158,"Puegnago del Garda",999,1696,1770,3466
"5462",62055,"Puglianello",999,646,652,1298
"5463",92050,"Pula",999,3586,3519,7105
"5464",30086,"Pulfero",999,430,400,830
"5465",73022,"Pulsano",999,5536,5646,11182
"5466",16177,"Pumenengo",999,874,831,1705
"5467",13193,"Pusiano",999,638,668,1306
"5468",90060,"Putifigari",999,343,324,667
"5469",72036,"Putignano",999,12662,13207,25869
"5470",64076,"Quadrelle",999,912,953,1865
"5471",69070,"Quadri",999,330,361,691
"5472",1208,"Quagliuzzo",999,181,155,336
"5473",63062,"Qualiano",999,12206,12370,24576
"5474",5088,"Quaranti",999,86,69,155
"5475",96087,"Quaregna Cerreto",999,1017,1023,2040
"5476",6141,"Quargnento",999,634,702,1336
"5477",103058,"Quarna Sopra",999,112,123,235
"5478",103059,"Quarna Sotto",999,192,184,376
"5479",2107,"Quarona",999,1766,1996,3762
"5480",47017,"Quarrata",999,13194,13705,26899
"5481",7054,"Quart",999,2062,2065,4127
"5482",63063,"Quarto",999,20337,20987,41324
"5483",27031,"Quarto d'Altino",999,3948,4113,8061
"5484",92105,"Quartucciu",999,6298,6544,12842
"5485",92051,"Quartu Sant'Elena",999,33427,35036,68463
"5486",1209,"Quassolo",999,159,173,332
"5487",6142,"Quattordio",999,708,760,1468
"5488",35030,"Quattro Castella",999,6462,6787,13249
"5489",25070,"Quero Vas",999,1564,1522,3086
"5490",9052,"Quiliano",999,3333,3530,6863
"5491",1210,"Quincinetto",999,477,506,983
"5492",64077,"Quindici",999,880,890,1770
"5493",20046,"Quingentole",999,498,525,1023
"5494",19078,"Quintano",999,460,460,920
"5495",26064,"Quinto di Treviso",999,4965,5093,10058
"5496",2108,"Quinto Vercellese",999,193,193,386
"5497",24083,"Quinto Vicentino",999,2875,2935,5810
"5498",17159,"Quinzano d'Oglio",999,3123,3108,6231
"5499",20047,"Quistello",999,2596,2681,5277
"5500",22150,"Rabbi",999,703,669,1372
"5501",75063,"Racale",999,5167,5548,10715
"5502",84029,"Racalmuto",999,3710,3821,7531
"5503",4179,"Racconigi",999,4815,4869,9684
"5504",83069,"Raccuja",999,409,425,834
"5505",21070,"Racines/Ratschings",999,2394,2261,4655
"5506",52023,"Radda in Chianti",999,709,740,1449
"5507",87036,"Raddusa",999,1381,1406,2787
"5508",52024,"Radicofani",999,509,542,1051
"5509",52025,"Radicondoli",999,509,463,972
"5510",84030,"Raffadali",999,5753,6102,11855
"5511",87058,"Ragalna",999,2171,2045,4216
"5512",30087,"Ragogna",999,1394,1426,2820
"5513",88009,"Ragusa",999,36006,37678,73684
"5514",66077,"Raiano",999,1242,1379,2621
"5515",87037,"Ramacca",999,5104,5083,10187
"5516",12115,"Rancio Valcuvia",999,470,454,924
"5517",12116,"Ranco",999,627,614,1241
"5518",87038,"Randazzo",999,4868,5288,10156
"5519",16178,"Ranica",999,2846,3046,5892
"5520",16179,"Ranzanico",999,644,619,1263
"5521",8048,"Ranzo",999,271,288,559
"5522",109035,"Rapagnano",999,954,970,1924
"5523",10046,"Rapallo",999,14022,15398,29420
"5524",69071,"Rapino",999,573,589,1162
"5525",52026,"Rapolano Terme",999,2517,2597,5114
"5526",76064,"Rapolla",999,2113,2035,4148
"5527",76065,"Rapone",999,396,444,840
"5528",2110,"Rassa",999,42,26,68
"5529",21071,"Rasun-Anterselva/Rasen-Antholz",999,1478,1461,2939
"5530",14055,"Rasura",999,151,137,288
"5531",84031,"Ravanusa",999,4992,5267,10259
"5532",36034,"Ravarino",999,3103,3195,6298
"5533",30088,"Ravascletto",999,265,244,509
"5534",65104,"Ravello",999,1160,1212,2372
"5535",39014,"Ravenna",999,76137,80208,156345
"5536",30089,"Raveo",999,216,221,437
"5537",61066,"Raviscanina",999,572,586,1158
"5538",103060,"Re",999,355,361,716
"5539",18119,"Rea",999,177,217,394
"5540",84032,"Realmonte",999,2146,2232,4378
"5541",30090,"Reana del Rojale",999,2267,2371,4638
"5542",1211,"Reano",999,860,884,1744
"5543",61067,"Recale",999,3783,3830,7613
"5544",43044,"Recanati",999,10051,10645,20696
"5545",10047,"Recco",999,4393,4965,9358
"5546",3129,"Recetto",999,537,464,1001
"5547",24084,"Recoaro Terme",999,2923,2967,5890
"5548",18120,"Redavalle",999,520,495,1015
"5549",20048,"Redondesco",999,604,610,1214
"5550",5089,"Refrancore",999,753,785,1538
"5551",26065,"Refrontolo",999,855,852,1707
"5552",86016,"Regalbuto",999,3287,3342,6629
"5553",48035,"Reggello",999,8177,8381,16558
"5554",80063,"Reggio di Calabria",999,81350,88445,169795
"5555",35032,"Reggiolo",999,4663,4613,9276
"5556",35033,"Reggio nell'Emilia",999,84862,86480,171342
"5557",62056,"Reino",999,533,564,1097
"5558",83070,"Reitano",999,358,347,705
"5559",30091,"Remanzacco",999,2907,3108,6015
"5560",17160,"Remedello",999,1712,1706,3418
"5561",108037,"Renate",999,1999,1986,3985
"5562",78102,"Rende",999,18074,18583,36657
"5563",21072,"Renon/Ritten",999,4086,4070,8156
"5564",26066,"Resana",999,4675,4677,9352
"5565",15181,"Rescaldina",999,7002,7244,14246
"5566",30092,"Resia",999,476,441,917
"5567",30093,"Resiutta",999,134,133,267
"5568",85014,"Resuttano",999,839,878,1717
"5569",18121,"Retorbido",999,721,812,1533
"5570",4180,"Revello",999,2124,2044,4168
"5571",5090,"Revigliasco d'Asti",999,364,364,728
"5572",26067,"Revine Lago",999,1046,1042,2088
"5573",13195,"Rezzago",999,168,138,306
"5574",17161,"Rezzato",999,6661,6814,13475
"5575",8049,"Rezzo",999,159,154,313
"5576",10048,"Rezzoaglio",999,431,428,859
"5577",7055,"Rhêmes-Notre-Dame",999,41,35,76
"5578",7056,"Rhêmes-Saint-Georges",999,87,76,163
"5579",15182,"Rho",999,24524,26323,50847
"5580",80064,"Riace",999,896,893,1789
"5581",9053,"Rialto",999,276,256,532
"5582",58081,"Riano",999,5213,5206,10419
"5583",61068,"Riardo",999,1095,1128,2223
"5584",84033,"Ribera",999,8602,9159,17761
"5585",1212,"Ribordone",999,28,24,52
"5586",102030,"Ricadi",999,2574,2457,5031
"5587",6143,"Ricaldone",999,314,293,607
"5588",70057,"Riccia",999,2367,2424,4791
"5589",99013,"Riccione",999,16217,18214,34431
"5590",11023,"Riccò del Golfo di Spezia",999,1780,1816,3596
"5591",19079,"Ricengo",999,891,842,1733
"5592",65105,"Ricigliano",999,532,532,1064
"5593",26068,"Riese Pio X",999,5499,5445,10944
"5594",85015,"Riesi",999,4953,5448,10401
"5595",57059,"Rieti",999,21923,23350,45273
"5596",21073,"Rifiano/Riffian",999,688,677,1365
"5597",4181,"Rifreddo",999,518,521,1039
"5598",58082,"Rignano Flaminio",999,4941,5162,10103
"5599",71041,"Rignano Garganico",999,881,909,1790
"5600",48036,"Rignano sull'Arno",999,4253,4310,8563
"5601",30094,"Rigolato",999,196,177,373
"5602",2113,"Rimella",999,80,53,133
"5603",99014,"Rimini",999,72399,77873,150272
"5604",49021,"Rio",999,1709,1672,3381
"5605",21074,"Rio di Pusteria/Mühlbach",999,1623,1579,3202
"5606",58083,"Riofreddo",999,367,389,756
"5607",95043,"Riola Sardo",999,1038,978,2016
"5608",39015,"Riolo Terme",999,2911,2886,5797
"5609",36035,"Riolunato",999,336,330,666
"5610",11024,"Riomaggiore",999,659,652,1311
"5611",76066,"Rionero in Vulture",999,6229,6270,12499
"5612",94039,"Rionero Sannitico",999,513,459,972
"5613",35034,"Rio Saliceto",999,3006,3033,6039
"5614",70058,"Ripabottoni",999,224,208,432
"5615",76067,"Ripacandida",999,807,765,1572
"5616",70059,"Ripalimosani",999,1548,1449,2997
"5617",19080,"Ripalta Arpina",999,540,512,1052
"5618",19081,"Ripalta Cremasca",999,1743,1702,3445
"5619",19082,"Ripalta Guerina",999,288,258,546
"5620",50030,"Riparbella",999,833,790,1623
"5621",69072,"Ripa Teatina",999,1968,1921,3889
"5622",44063,"Ripatransone",999,2062,2084,4146
"5623",43045,"Ripe San Ginesio",999,394,406,800
"5624",60058,"Ripi",999,2509,2519,5028
"5625",87039,"Riposto",999,6856,7135,13991
"5626",4182,"Rittana",999,52,51,103
"5627",22153,"Riva del Garda",999,8549,9309,17858
"5628",38029,"Riva del Po",999,3660,3772,7432
"5629",16180,"Riva di Solto",999,423,433,856
"5630",1213,"Rivalba",999,582,566,1148
"5631",8050,"Riva Ligure",999,1392,1395,2787
"5632",6144,"Rivalta Bormida",999,677,688,1365
"5633",1214,"Rivalta di Torino",999,10009,10241,20250
"5634",25043,"Rivamonte Agordino",999,315,286,601
"5635",18122,"Rivanazzano Terme",999,2452,2639,5091
"5636",1215,"Riva presso Chieri",999,2333,2418,4751
"5637",1216,"Rivara",999,1234,1263,2497
"5638",1217,"Rivarolo Canavese",999,6010,6383,12393
"5639",19083,"Rivarolo del Re ed Uniti",999,929,901,1830
"5640",20050,"Rivarolo Mantovano",999,1173,1197,2370
"5641",6145,"Rivarone",999,228,162,390
"5642",1218,"Rivarossa",999,782,770,1552
"5643",2115,"Rive",999,217,228,445
"5644",30095,"Rive d'Arcano",999,1152,1215,2367
"5645",76068,"Rivello",999,1229,1289,2518
"5646",33038,"Rivergaro",999,3514,3616,7130
"5647",30188,"Rivignano Teor",999,3151,3100,6251
"5648",66078,"Rivisondoli",999,352,296,648
"5649",57060,"Rivodutri",999,604,548,1152
"5650",1219,"Rivoli",999,22566,24371,46937
"5651",23062,"Rivoli Veronese",999,1164,1108,2272
"5652",19084,"Rivolta d'Adda",999,4068,4175,8243
"5653",80065,"Rizziconi",999,3924,3751,7675
"5654",24085,"Roana",999,2113,2034,4147
"5655",4183,"Roaschia",999,46,49,95
"5656",4184,"Roascio",999,45,46,91
"5657",2116,"Roasio",999,1082,1144,2226
"5658",5091,"Roatto",999,184,174,358
"5659",1220,"Robassomero",999,1500,1588,3088
"5660",97071,"Robbiate",999,3156,3160,6316
"5661",18123,"Robbio",999,2849,3000,5849
"5662",15183,"Robecchetto con Induno",999,2377,2418,4795
"5663",19085,"Robecco d'Oglio",999,1090,1171,2261
"5664",18124,"Robecco Pavese",999,261,251,512
"5665",15184,"Robecco sul Naviglio",999,3315,3475,6790
"5666",5092,"Robella",999,246,202,448
"5667",4185,"Robilante",999,1055,1072,2127
"5668",4186,"Roburent",999,249,228,477
"5669",64078,"Roccabascerana",999,1194,1152,2346
"5670",101018,"Roccabernarda",999,1544,1586,3130
"5671",34030,"Roccabianca",999,1443,1469,2912
"5672",4187,"Roccabruna",999,762,770,1532
"5673",1221,"Rocca Canavese",999,861,882,1743
"5674",58084,"Rocca Canterano",999,96,77,173
"5675",66079,"Roccacasale",999,295,295,590
"5676",4188,"Rocca Cigliè",999,58,63,121
"5677",5093,"Rocca d'Arazzo",999,476,447,923
"5678",60059,"Rocca d'Arce",999,440,433,873
"5679",65106,"Roccadaspide",999,3376,3513,6889
"5680",4189,"Rocca de' Baldi",999,790,786,1576
"5681",18125,"Rocca de' Giorgi",999,23,22,45
"5682",61069,"Rocca d'Evandro",999,1486,1516,3002
"5683",66080,"Rocca di Botte",999,462,394,856
"5684",66081,"Rocca di Cambio",999,268,236,504
"5685",58085,"Rocca di Cave",999,182,178,360
"5686",66082,"Rocca di Mezzo",999,695,665,1360
"5687",101019,"Rocca di Neto",999,2627,2680,5307
"5688",58086,"Rocca di Papa",999,9243,8590,17833
"5689",83071,"Roccafiorita",999,85,93,178
"5690",44064,"Roccafluvione",999,938,907,1845
"5691",80066,"Roccaforte del Greco",999,160,156,316
"5692",6146,"Roccaforte Ligure",999,72,48,120
"5693",4190,"Roccaforte Mondovì",999,1117,1014,2131
"5694",73023,"Roccaforzata",999,861,903,1764
"5695",17162,"Roccafranca",999,2496,2414,4910
"5696",58087,"Roccagiovine",999,123,121,244
"5697",65107,"Roccagloriosa",999,785,775,1560
"5698",59021,"Roccagorga",999,2064,2086,4150
"5699",6147,"Rocca Grimalda",999,717,688,1405
"5700",78103,"Rocca Imperiale",999,1565,1604,3169
"5701",53020,"Roccalbegna",999,457,461,918
"5702",83072,"Roccalumera",999,1953,2111,4064
"5703",94040,"Roccamandolfi",999,408,411,819
"5704",59022,"Rocca Massima",999,568,513,1081
"5705",82061,"Roccamena",999,640,674,1314
"5706",61070,"Roccamonfina",999,1549,1601,3150
"5707",69073,"Roccamontepiano",999,780,789,1569
"5708",68034,"Roccamorice",999,424,444,868
"5709",76069,"Roccanova",999,627,656,1283
"5710",57061,"Roccantica",999,267,275,542
"5711",82062,"Roccapalumba",999,1039,1092,2131
"5712",66083,"Rocca Pia",999,89,81,170
"5713",65108,"Roccapiemonte",999,4291,4417,8708
"5714",25044,"Rocca Pietore",999,568,572,1140
"5715",58088,"Rocca Priora",999,5996,6028,12024
"5716",63065,"Roccarainola",999,3214,3351,6565
"5717",66084,"Roccaraso",999,741,744,1485
"5718",61071,"Roccaromana",999,382,439,821
"5719",40036,"Rocca San Casciano",999,882,898,1780
"5720",64079,"Rocca San Felice",999,383,388,771
"5721",69074,"Rocca San Giovanni",999,1155,1151,2306
"5722",67036,"Rocca Santa Maria",999,247,207,454
"5723",58089,"Rocca Santo Stefano",999,473,439,912
"5724",69075,"Roccascalegna",999,523,499,1022
"5725",60060,"Roccasecca",999,3384,3376,6760
"5726",59023,"Roccasecca dei Volsci",999,531,518,1049
"5727",94041,"Roccasicura",999,242,234,476
"5728",57062,"Rocca Sinibalda",999,413,365,778
"5729",4191,"Roccasparvera",999,383,359,742
"5730",69076,"Roccaspinalveti",999,563,600,1163
"5731",53021,"Roccastrada",999,4319,4473,8792
"5732",18126,"Rocca Susella",999,118,114,232
"5733",83073,"Roccavaldina",999,486,517,1003
"5734",5094,"Roccaverano",999,199,172,371
"5735",9054,"Roccavignale",999,390,371,761
"5736",4192,"Roccavione",999,1298,1304,2602
"5737",70060,"Roccavivara",999,290,316,606
"5738",80067,"Roccella Ionica",999,2897,3219,6116
"5739",83074,"Roccella Valdemone",999,278,282,560
"5740",94042,"Rocchetta a Volturno",999,537,525,1062
"5741",4193,"Rocchetta Belbo",999,82,75,157
"5742",11025,"Rocchetta di Vara",999,336,311,647
"5743",61072,"Rocchetta e Croce",999,225,205,430
"5744",6148,"Rocchetta Ligure",999,125,99,224
"5745",8051,"Rocchetta Nervina",999,151,132,283
"5746",5095,"Rocchetta Palafea",999,170,165,335
"5747",71042,"Rocchetta Sant'Antonio",999,803,854,1657
"5748",5096,"Rocchetta Tanaro",999,644,675,1319
"5749",15185,"Rodano",999,2297,2347,4644
"5750",4194,"Roddi",999,819,774,1593
"5751",4195,"Roddino",999,220,192,412
"5752",4196,"Rodello",999,478,492,970
"5753",21075,"Rodengo/Rodeneck",999,661,630,1291
"5754",17163,"Rodengo Saiano",999,4843,5082,9925
"5755",13197,"Rodero",999,645,636,1281
"5756",71043,"Rodi Garganico",999,1670,1660,3330
"5757",20051,"Rodigo",999,2560,2611,5171
"5758",83075,"Rodì Milici",999,961,998,1959
"5759",17164,"Roè Volciano",999,2108,2228,4336
"5760",65109,"Rofrano",999,644,614,1258
"5761",97072,"Rogeno",999,1525,1465,2990
"5762",78104,"Roggiano Gravina",999,3306,3458,6764
"5763",80068,"Roghudi",999,450,480,930
"5764",78105,"Rogliano",999,2564,2632,5196
"5765",18127,"Rognano",999,346,357,703
"5766",16182,"Rogno",999,1914,1909,3823
"5767",14056,"Rogolo",999,284,286,570
"5768",58090,"Roiate",999,309,324,633
"5769",69077,"Roio del Sangro",999,51,48,99
"5770",7057,"Roisan",999,513,503,1016
"5771",1222,"Roletto",999,993,985,1978
"5772",35035,"Rolo",999,2049,1952,4001
"5773",58091,"Roma",999,1308546,1446173,2754719
"5774",65110,"Romagnano al Monte",999,176,194,370
"5775",3130,"Romagnano Sesia",999,1791,1915,3706
"5776",18128,"Romagnese",999,305,254,559
"5777",90061,"Romana",999,227,248,475
"5778",19086,"Romanengo",999,1587,1635,3222
"5779",1223,"Romano Canavese",999,1313,1353,2666
"5780",24086,"Romano d'Ezzelino",999,7029,7164,14193
"5781",16183,"Romano di Lombardia",999,10531,10224,20755
"5782",31015,"Romans d'Isonzo",999,1762,1817,3579
"5783",102031,"Rombiolo",999,2152,2114,4266
"5784",22155,"Romeno",999,761,736,1497
"5785",3131,"Romentino",999,2763,2841,5604
"5786",83076,"Rometta",999,3232,3364,6596
"5787",13199,"Ronago",999,831,829,1660
"5788",23063,"Roncà",999,1915,1855,3770
"5789",26069,"Roncade",999,7264,7374,14638
"5790",17165,"Roncadelle",999,4610,4714,9324
"5791",18129,"Roncaro",999,808,783,1591
"5792",22156,"Roncegno Terme",999,1462,1478,2940
"5793",108055,"Roncello",999,2402,2397,4799
"5794",31016,"Ronchi dei Legionari",999,5819,6022,11841
"5795",30097,"Ronchis",999,954,957,1911
"5796",22157,"Ronchi Valsugana",999,240,211,451
"5797",56045,"Ronciglione",999,4217,4232,8449
"5798",23064,"Ronco all'Adige",999,3055,2958,6013
"5799",16184,"Roncobello",999,224,208,432
"5800",96053,"Ronco Biellese",999,726,704,1430
"5801",108038,"Ronco Briantino",999,1845,1838,3683
"5802",1224,"Ronco Canavese",999,164,146,310
"5803",20052,"Roncoferraro",999,3406,3493,6899
"5804",40037,"Roncofreddo",999,1758,1696,3454
"5805",16185,"Roncola",999,487,439,926
"5806",10049,"Ronco Scrivia",999,2109,2058,4167
"5807",10050,"Rondanina",999,34,25,59
"5808",1225,"Rondissone",999,976,945,1921
"5809",2118,"Ronsecco",999,262,300,562
"5810",22135,"Ronzo-Chienis",999,527,475,1002
"5811",22159,"Ronzone",999,246,236,482
"5812",96054,"Roppolo",999,398,433,831
"5813",1226,"Rorà",999,125,93,218
"5814",24087,"Rosà",999,7256,7406,14662
"5815",80069,"Rosarno",999,7236,7201,14437
"5816",18130,"Rosasco",999,261,274,535
"5817",15188,"Rosate",999,2818,2890,5708
"5818",96055,"Rosazza",999,44,53,97
"5819",68035,"Rosciano",999,1969,2070,4039
"5820",65111,"Roscigno",999,296,298,594
"5821",78106,"Rose",999,2053,2060,4113
"5822",69078,"Rosello",999,79,88,167
"5823",78107,"Roseto Capo Spulico",999,926,937,1863
"5824",67037,"Roseto degli Abruzzi",999,12457,13183,25640
"5825",71044,"Roseto Valfortore",999,480,511,991
"5826",49017,"Rosignano Marittimo",999,14541,15502,30043
"5827",6149,"Rosignano Monferrato",999,702,725,1427
"5828",29040,"Rosolina",999,3085,3097,6182
"5829",89016,"Rosolini",999,10213,10367,20580
"5830",42040,"Rosora",999,907,917,1824
"5831",2121,"Rossa",999,94,69,163
"5832",4197,"Rossana",999,422,401,823
"5833",24088,"Rossano Veneto",999,4111,4146,8257
"5834",10051,"Rossiglione",999,1217,1310,2527
"5835",1228,"Rosta",999,2507,2599,5106
"5836",16186,"Rota d'Imagna",999,449,459,908
"5837",78109,"Rota Greca",999,471,463,934
"5838",44065,"Rotella",999,403,388,791
"5839",70061,"Rotello",999,580,538,1118
"5840",76070,"Rotonda",999,1593,1580,3173
"5841",77023,"Rotondella",999,1161,1247,2408
"5842",64080,"Rotondi",999,1751,1662,3413
"5843",33039,"Rottofreno",999,6030,6251,12281
"5844",24089,"Rotzo",999,311,323,634
"5845",1227,"Roure",999,368,390,758
"5846",2122,"Rovasenda",999,436,458,894
"5847",17166,"Rovato",999,9976,9501,19477
"5848",10052,"Rovegno",999,264,203,467
"5849",13201,"Rovellasca",999,3969,4040,8009
"5850",13202,"Rovello Porro",999,3116,3182,6298
"5851",20053,"Roverbella",999,4331,4358,8689
"5852",23065,"Roverchiara",999,1345,1235,2580
"5853",22160,"Roverè della Luna",999,836,801,1637
"5854",23066,"Roveredo di Guà",999,803,820,1623
"5855",93036,"Roveredo in Piano",999,2824,2989,5813
"5856",22161,"Rovereto",999,19225,20822,40047
"5857",23067,"Roverè Veronese",999,1075,1040,2115
"5858",18131,"Rovescala",999,412,399,811
"5859",16187,"Rovetta",999,2025,2091,4116
"5860",58092,"Roviano",999,590,654,1244
"5861",29041,"Rovigo",999,24252,25847,50099
"5862",78110,"Rovito",999,1506,1476,2982
"5863",28071,"Rovolon",999,2444,2438,4882
"5864",15189,"Rozzano",999,20082,21276,41358
"5865",28072,"Rubano",999,8233,8781,17014
"5866",1229,"Rubiana",999,1228,1203,2431
"5867",35036,"Rubiera",999,7226,7531,14757
"5868",30098,"Ruda",999,1363,1428,2791
"5869",17167,"Rudiano",999,3001,2939,5940
"5870",1230,"Rueglio",999,399,411,810
"5871",75064,"Ruffano",999,4468,4823,9291
"5872",4198,"Ruffia",999,192,169,361
"5873",22162,"Ruffrè-Mendola",999,224,196,420
"5874",48037,"Rufina",999,3478,3576,7054
"5875",95044,"Ruinas",999,284,302,586
"5876",22163,"Rumo",999,405,383,788
"5877",76071,"Ruoti",999,1599,1628,3227
"5878",39016,"Russi",999,6059,6238,12297
"5879",72037,"Rutigliano",999,8939,9271,18210
"5880",65112,"Rutino",999,400,367,767
"5881",61073,"Ruviano",999,824,867,1691
"5882",76072,"Ruvo del Monte",999,488,486,974
"5883",72038,"Ruvo di Puglia",999,11898,12456,24354
"5884",59024,"Sabaudia",999,9815,9600,19415
"5885",17168,"Sabbio Chiese",999,2064,1981,4045
"5886",20054,"Sabbioneta",999,2054,2043,4097
"5887",65113,"Sacco",999,217,215,432
"5888",28073,"Saccolongo",999,2477,2467,4944
"5889",93037,"Sacile",999,9740,10307,20047
"5890",58093,"Sacrofano",999,3619,3791,7410
"5891",111058,"Sadali",999,399,410,809
"5892",95086,"Sagama",999,94,94,188
"5893",96056,"Sagliano Micca",999,742,809,1551
"5894",31017,"Sagrado",999,1046,1076,2122
"5895",22164,"Sagron Mis",999,89,88,177
"5896",7058,"Saint-Christophe",999,1767,1728,3495
"5897",7059,"Saint-Denis",999,190,177,367
"5898",7060,"Saint-Marcel",999,651,676,1327
"5899",7061,"Saint-Nicolas",999,179,155,334
"5900",7062,"Saint-Oyen",999,85,109,194
"5901",7063,"Saint-Pierre",999,1636,1659,3295
"5902",7064,"Saint-Rhémy-en-Bosses",999,182,152,334
"5903",7065,"Saint-Vincent",999,2178,2277,4455
"5904",34031,"Sala Baganza",999,3060,2894,5954
"5905",96057,"Sala Biellese",999,264,276,540
"5906",37050,"Sala Bolognese",999,4213,4213,8426
"5907",13203,"Sala Comacina",999,228,240,468
"5908",65114,"Sala Consilina",999,5968,6220,12188
"5909",6150,"Sala Monferrato",999,155,176,331
"5910",77024,"Salandra",999,1224,1259,2483
"5911",81017,"Salaparuta",999,746,801,1547
"5912",29042,"Salara",999,488,538,1026
"5913",2126,"Salasco",999,115,95,210
"5914",1231,"Salassa",999,916,925,1841
"5915",1232,"Salbertrand",999,335,293,628
"5916",24090,"Salcedo",999,507,505,1012
"5917",70062,"Salcito",999,334,297,631
"5918",6151,"Sale",999,1905,1952,3857
"5919",4199,"Sale delle Langhe",999,235,218,453
"5920",17169,"Sale Marasino",999,1597,1676,3273
"5921",81018,"Salemi",999,5001,4973,9974
"5922",65115,"Salento",999,862,897,1759
"5923",1233,"Salerano Canavese",999,229,226,455
"5924",98046,"Salerano sul Lambro",999,1325,1335,2660
"5925",65116,"Salerno",999,59504,67121,126625
"5926",4200,"Sale San Giovanni",999,76,76,152
"5927",26070,"Salgareda",999,3294,3232,6526
"5928",75065,"Salice Salentino",999,3729,3989,7718
"5929",4201,"Saliceto",999,562,595,1157
"5930",57063,"Salisano",999,233,248,481
"5931",2127,"Sali Vercellese",999,47,48,95
"5932",23068,"Salizzole",999,1962,1820,3782
"5933",68036,"Salle",999,130,130,260
"5934",4202,"Salmour",999,391,328,719
"5935",17170,"Salò",999,4880,5514,10394
"5936",21076,"Salorno sulla strada del vino/Salurn an der Weinstraße",999,1919,1891,3810
"5937",34032,"Salsomaggiore Terme",999,10142,10163,20305
"5938",12117,"Saltrio",999,1441,1548,2989
"5939",99015,"Saludecio",999,1585,1568,3153
"5940",2128,"Saluggia",999,1850,1942,3792
"5941",96058,"Salussola",999,941,888,1829
"5942",4203,"Saluzzo",999,8657,8896,17553
"5943",75066,"Salve",999,2193,2368,4561
"5944",19087,"Salvirola",999,567,565,1132
"5945",65117,"Salvitelle",999,237,245,482
"5946",1234,"Salza di Pinerolo",999,46,25,71
"5947",64081,"Salza Irpina",999,371,364,735
"5948",27032,"Salzano",999,6357,6456,12813
"5949",12118,"Samarate",999,7977,8132,16109
"5950",111059,"Samassi",999,2332,2426,4758
"5951",111060,"Samatzai",999,754,768,1522
"5952",84034,"Sambuca di Sicilia",999,2652,2669,5321
"5953",47018,"Sambuca Pistoiese",999,743,698,1441
"5954",58094,"Sambuci",999,410,422,832
"5955",4204,"Sambuco",999,41,42,83
"5956",72039,"Sammichele di Bari",999,2893,3075,5968
"5957",80070,"Samo",999,343,360,703
"5958",14057,"Samolaco",999,1411,1470,2881
"5959",22165,"Samone",999,278,268,546
"5960",1235,"Samone",999,750,761,1511
"5961",4205,"Sampeyre",999,506,495,1001
"5962",95045,"Samugheo",999,1341,1368,2709
"5963",75067,"Sanarica",999,709,769,1478
"5964",8052,"San Bartolomeo al Mare",999,1412,1548,2960
"5965",62057,"San Bartolomeo in Galdo",999,2131,2168,4299
"5966",13204,"San Bartolomeo Val Cavargna",999,458,498,956
"5967",78111,"San Basile",999,427,487,914
"5968",111061,"San Basilio",999,567,531,1098
"5969",19088,"San Bassano",999,1012,1065,2077
"5970",29043,"San Bellino",999,537,511,1048
"5971",4206,"San Benedetto Belbo",999,76,72,148
"5972",66085,"San Benedetto dei Marsi",999,1849,1846,3695
"5973",44066,"San Benedetto del Tronto",999,22274,24760,47034
"5974",66086,"San Benedetto in Perillis",999,56,42,98
"5975",20055,"San Benedetto Po",999,3362,3326,6688
"5976",78112,"San Benedetto Ullano",999,685,680,1365
"5977",37051,"San Benedetto Val di Sambro",999,2155,2035,4190
"5978",1236,"San Benigno Canavese",999,3017,3090,6107
"5979",103061,"San Bernardino Verbano",999,636,623,1259
"5980",8053,"San Biagio della Cima",999,600,638,1238
"5981",26071,"San Biagio di Callalta",999,6363,6318,12681
"5982",84035,"San Biagio Platani",999,1336,1493,2829
"5983",60061,"San Biagio Saracinisco",999,145,149,294
"5984",70063,"San Biase",999,67,67,134
"5985",23069,"San Bonifacio",999,10824,10674,21498
"5986",69079,"San Buono",999,438,415,853
"5987",102032,"San Calogero",999,1904,1916,3820
"5988",21077,"San Candido/Innichen",999,1623,1717,3340
"5989",31018,"San Canzian d'Isonzo",999,2989,3031,6020
"5990",1237,"San Carlo Canavese",999,2000,2031,4031
"5991",52027,"San Casciano dei Bagni",999,718,734,1452
"5992",48038,"San Casciano in Val di Pesa",999,7913,8523,16436
"5993",75095,"San Cassiano",999,983,961,1944
"5994",85016,"San Cataldo",999,9960,10699,20659
"5995",58119,"San Cesareo",999,8104,8137,16241
"5996",75068,"San Cesario di Lecce",999,3786,4103,7889
"5997",36036,"San Cesario sul Panaro",999,3334,3266,6600
"5998",76073,"San Chirico Nuovo",999,577,563,1140
"5999",76074,"San Chirico Raparo",999,478,441,919
"6000",82063,"San Cipirello",999,2380,2504,4884
"6001",61074,"San Cipriano d'Aversa",999,6653,6610,13263
"6002",65118,"San Cipriano Picentino",999,3245,3338,6583
"6003",18133,"San Cipriano Po",999,234,214,448
"6004",99016,"San Clemente",999,2870,2935,5805
"6005",15191,"San Colombano al Lambro",999,3615,3724,7339
"6006",1238,"San Colombano Belmonte",999,180,180,360
"6007",10053,"San Colombano Certenoli",999,1361,1306,2667
"6008",87040,"San Cono",999,1237,1214,2451
"6009",78113,"San Cosmo Albanese",999,258,300,558
"6010",76075,"San Costantino Albanese",999,290,311,601
"6011",102033,"San Costantino Calabro",999,997,1050,2047
"6012",41051,"San Costanzo",999,2327,2234,4561
"6013",6152,"San Cristoforo",999,249,271,520
"6014",18134,"San Damiano al Colle",999,315,293,608
"6015",5097,"San Damiano d'Asti",999,3976,4065,8041
"6016",4207,"San Damiano Macra",999,217,196,413
"6017",30099,"San Daniele del Friuli",999,3823,4100,7923
"6018",19089,"San Daniele Po",999,638,618,1256
"6019",78114,"San Demetrio Corone",999,1449,1573,3022
"6020",66087,"San Demetrio ne' Vestini",999,994,961,1955
"6021",1239,"San Didero",999,252,253,505
"6022",96059,"Sandigliano",999,1230,1351,2581
"6023",74013,"San Donaci",999,2976,3164,6140
"6024",27033,"San Donà di Piave",999,20125,21758,41883
"6025",75069,"San Donato di Lecce",999,2546,2868,5414
"6026",78115,"San Donato di Ninea",999,513,553,1066
"6027",15192,"San Donato Milanese",999,15636,16660,32296
"6028",60062,"San Donato Val di Comino",999,890,970,1860
"6029",32004,"San Dorligo della Valle-Dolina",999,2824,2858,5682
"6030",24091,"Sandrigo",999,4092,4205,8297
"6031",76076,"San Fele",999,1238,1297,2535
"6032",61075,"San Felice a Cancello",999,8327,8519,16846
"6033",59025,"San Felice Circeo",999,5318,4853,10171
"6034",17171,"San Felice del Benaco",999,1668,1775,3443
"6035",70064,"San Felice del Molise",999,270,271,541
"6036",36037,"San Felice sul Panaro",999,5383,5441,10824
"6037",80097,"San Ferdinando",999,2263,2046,4309
"6038",110007,"San Ferdinando di Puglia",999,6889,6826,13715
"6039",13206,"San Fermo della Battaglia",999,3759,3973,7732
"6040",78116,"San Fili",999,1242,1232,2474
"6041",83077,"San Filippo del Mela",999,3316,3375,6691
"6042",26072,"San Fior",999,3402,3416,6818
"6043",98047,"San Fiorano",999,935,941,1876
"6044",31019,"San Floriano del Collio",999,364,372,736
"6045",79108,"San Floro",999,343,350,693
"6046",1240,"San Francesco al Campo",999,2377,2458,4835
"6047",83078,"San Fratello",999,1587,1611,3198
"6048",4208,"Sanfrè",999,1492,1569,3061
"6049",4209,"Sanfront",999,1115,1137,2252
"6050",1241,"Sangano",999,1745,1943,3688
"6051",111062,"San Gavino Monreale",999,3883,4092,7975
"6052",55029,"San Gemini",999,2250,2441,4691
"6053",21079,"San Genesio Atesino/Jenesien",999,1536,1478,3014
"6054",18135,"San Genesio ed Uniti",999,1915,2060,3975
"6055",63066,"San Gennaro Vesuviano",999,6284,5813,12097
"6056",1242,"San Germano Chisone",999,874,859,1733
"6057",2131,"San Germano Vercellese",999,793,787,1580
"6058",17172,"San Gervasio Bresciano",999,1331,1343,2674
"6059",70065,"San Giacomo degli Schiavoni",999,673,696,1369
"6060",20056,"San Giacomo delle Segnate",999,746,768,1514
"6061",14058,"San Giacomo Filippo",999,189,175,364
"6062",2035,"San Giacomo Vercellese",999,129,135,264
"6063",12141,"Sangiano",999,738,696,1434
"6064",1243,"San Gillio",999,1575,1683,3258
"6065",52028,"San Gimignano",999,3845,3645,7490
"6066",43046,"San Ginesio",999,1531,1529,3060
"6067",78117,"Sangineto",999,624,597,1221
"6068",63067,"San Giorgio a Cremano",999,19868,22279,42147
"6069",78118,"San Giorgio Albanese",999,636,674,1310
"6070",60063,"San Giorgio a Liri",999,1465,1507,2972
"6071",20057,"San Giorgio Bigarello",999,5887,5962,11849
"6072",1244,"San Giorgio Canavese",999,1244,1245,2489
"6073",93038,"San Giorgio della Richinvelda",999,2399,2158,4557
"6074",28075,"San Giorgio delle Pertiche",999,5089,5043,10132
"6075",62058,"San Giorgio del Sannio",999,4639,5034,9673
"6076",18136,"San Giorgio di Lomellina",999,511,475,986
"6077",30100,"San Giorgio di Nogaro",999,3608,3671,7279
"6078",37052,"San Giorgio di Piano",999,4694,4808,9502
"6079",28076,"San Giorgio in Bosco",999,3228,3181,6409
"6080",73024,"San Giorgio Ionico",999,6791,7280,14071
"6081",62059,"San Giorgio La Molara",999,1375,1355,2730
"6082",77025,"San Giorgio Lucano",999,514,499,1013
"6083",6153,"San Giorgio Monferrato",999,582,635,1217
"6084",80071,"San Giorgio Morgeto",999,1418,1515,2933
"6085",33040,"San Giorgio Piacentino",999,2739,2816,5555
"6086",5098,"San Giorgio Scarampi",999,46,47,93
"6087",15194,"San Giorgio su Legnano",999,3314,3426,6740
"6088",1245,"San Giorio di Susa",999,483,489,972
"6089",30101,"San Giovanni al Natisone",999,3070,2937,6007
"6090",65119,"San Giovanni a Piro",999,1776,1816,3592
"6091",16188,"San Giovanni Bianco",999,2327,2262,4589
"6092",20058,"San Giovanni del Dosso",999,620,626,1246
"6093",22250,"San Giovanni di Fassa-Sèn Jan",999,1767,1814,3581
"6094",80072,"San Giovanni di Gerace",999,195,211,406
"6095",84036,"San Giovanni Gemini",999,3731,3738,7469
"6096",23070,"San Giovanni Ilarione",999,2447,2406,4853
"6097",60064,"San Giovanni Incarico",999,1505,1547,3052
"6098",19090,"San Giovanni in Croce",999,965,953,1918
"6099",78119,"San Giovanni in Fiore",999,7624,8082,15706
"6100",70066,"San Giovanni in Galdo",999,246,260,506
"6101",99017,"San Giovanni in Marignano",999,4628,4788,9416
"6102",37053,"San Giovanni in Persiceto",999,13647,14342,27989
"6103",87041,"San Giovanni la Punta",999,11546,12449,23995
"6104",69080,"San Giovanni Lipioni",999,68,70,138
"6105",23071,"San Giovanni Lupatoto",999,12376,12919,25295
"6106",71046,"San Giovanni Rotondo",999,13018,13298,26316
"6107",111063,"San Giovanni Suergiu",999,2809,2792,5601
"6108",69081,"San Giovanni Teatino",999,7078,7334,14412
"6109",51033,"San Giovanni Valdarno",999,7866,8619,16485
"6110",70067,"San Giuliano del Sannio",999,495,480,975
"6111",70068,"San Giuliano di Puglia",999,468,505,973
"6112",15195,"San Giuliano Milanese",999,19880,20034,39914
"6113",50031,"San Giuliano Terme",999,15005,15757,30762
"6114",82064,"San Giuseppe Jato",999,3904,4115,8019
"6115",63068,"San Giuseppe Vesuviano",999,15738,14692,30430
"6116",54044,"San Giustino",999,5439,5658,11097
"6117",1246,"San Giusto Canavese",999,1582,1680,3262
"6118",48039,"San Godenzo",999,514,525,1039
"6119",58095,"San Gregorio da Sassola",999,724,704,1428
"6120",87042,"San Gregorio di Catania",999,5506,5995,11501
"6121",102034,"San Gregorio d'Ippona",999,1282,1221,2503
"6122",65120,"San Gregorio Magno",999,1873,2013,3886
"6123",61076,"San Gregorio Matese",999,428,442,870
"6124",25045,"San Gregorio nelle Alpi",999,778,786,1564
"6125",23072,"Sanguinetto",999,2116,2084,4200
"6126",37054,"San Lazzaro di Savena",999,15735,17039,32774
"6127",99025,"San Leo",999,1434,1371,2805
"6128",30102,"San Leonardo",999,525,493,1018
"6129",21080,"San Leonardo in Passiria/St. Leonhard in Passeier",999,1863,1778,3641
"6130",62060,"San Leucio del Sannio",999,1430,1459,2889
"6131",62061,"San Lorenzello",999,1058,1057,2115
"6132",80073,"San Lorenzo",999,1055,1100,2155
"6133",8054,"San Lorenzo al Mare",999,577,638,1215
"6134",78120,"San Lorenzo Bellizzi",999,250,259,509
"6135",78121,"San Lorenzo del Vallo",999,1554,1524,3078
"6136",21081,"San Lorenzo di Sebato/St. Lorenzen",999,1960,1936,3896
"6137",22231,"San Lorenzo Dorsino",999,784,791,1575
"6138",41054,"San Lorenzo in Campo",999,1544,1639,3183
"6139",31020,"San Lorenzo Isontino",999,747,744,1491
"6140",62062,"San Lorenzo Maggiore",999,961,935,1896
"6141",56047,"San Lorenzo Nuovo",999,991,1029,2020
"6142",80074,"San Luca",999,1659,1739,3398
"6143",78122,"San Lucido",999,3443,3468,6911
"6144",62063,"San Lupo",999,343,342,685
"6145",111067,"Sanluri",999,3954,4127,8081
"6146",79110,"San Mango d'Aquino",999,686,730,1416
"6147",65121,"San Mango Piemonte",999,1303,1321,2624
"6148",64082,"San Mango sul Calore",999,584,520,1104
"6149",61077,"San Marcellino",999,7372,7486,14858
"6150",42041,"San Marcello",999,991,1029,2020
"6151",47024,"San Marcello Piteglio",999,3662,3955,7617
"6152",78123,"San Marco Argentano",999,3394,3461,6855
"6153",83079,"San Marco d'Alunzio",999,865,952,1817
"6154",62064,"San Marco dei Cavoti",999,1410,1528,2938
"6155",61104,"San Marco Evangelista",999,3175,3283,6458
"6156",71047,"San Marco in Lamis",999,6151,6319,12470
"6157",71048,"San Marco la Catola",999,421,436,857
"6158",5099,"San Martino Alfieri",999,350,324,674
"6159",93039,"San Martino al Tagliamento",999,747,730,1477
"6160",23073,"San Martino Buon Albergo",999,8157,8245,16402
"6161",1247,"San Martino Canavese",999,406,404,810
"6162",76077,"San Martino d'Agri",999,329,317,646
"6163",20059,"San Martino dall'Argine",999,779,803,1582
"6164",19091,"San Martino del Lago",999,184,197,381
"6165",78124,"San Martino di Finita",999,474,478,952
"6166",28077,"San Martino di Lupari",999,6613,6643,13256
"6167",29044,"San Martino di Venezze",999,1848,1890,3738
"6168",21082,"San Martino in Badia/St. Martin in Thurn",999,894,856,1750
"6169",21083,"San Martino in Passiria/St. Martin in Passeier",999,1666,1636,3302
"6170",70069,"San Martino in Pensilis",999,2197,2272,4469
"6171",35037,"San Martino in Rio",999,4115,4131,8246
"6172",98048,"San Martino in Strada",999,1881,1889,3770
"6173",62065,"San Martino Sannita",999,577,566,1143
"6174",18137,"San Martino Siccomario",999,3154,3236,6390
"6175",69082,"San Martino sulla Marrucina",999,412,430,842
"6176",64083,"San Martino Valle Caudina",999,2373,2413,4786
"6177",73025,"San Marzano di San Giuseppe",999,4437,4431,8868
"6178",5100,"San Marzano Oliveto",999,509,489,998
"6179",65122,"San Marzano sul Sarno",999,5092,5110,10202
"6180",70070,"San Massimo",999,446,381,827
"6181",1248,"San Maurizio Canavese",999,5063,5203,10266
"6182",3133,"San Maurizio d'Opaglio",999,1423,1573,2996
"6183",82065,"San Mauro Castelverde",999,663,653,1316
"6184",65123,"San Mauro Cilento",999,431,420,851
"6185",23074,"San Mauro di Saline",999,309,284,593
"6186",77026,"San Mauro Forte",999,639,585,1224
"6187",65124,"San Mauro la Bruca",999,260,277,537
"6188",101020,"San Mauro Marchesato",999,919,977,1896
"6189",40041,"San Mauro Pascoli",999,6032,6254,12286
"6190",1249,"San Mauro Torinese",999,9056,9541,18597
"6191",22167,"San Michele all'Adige",999,2062,2039,4101
"6192",27034,"San Michele al Tagliamento",999,5524,5823,11347
"6193",87043,"San Michele di Ganzaria",999,1390,1454,2844
"6194",64084,"San Michele di Serino",999,1215,1193,2408
"6195",4210,"San Michele Mondovì",999,909,949,1858
"6196",74014,"San Michele Salentino",999,2976,3098,6074
"6197",50032,"San Miniato",999,13600,14207,27807
"6198",62066,"San Nazzaro",999,411,414,825
"6199",18138,"Sannazzaro de' Burgondi",999,2550,2562,5112
"6200",3134,"San Nazzaro Sesia",999,366,334,700
"6201",13207,"San Nazzaro Val Cavargna",999,140,122,262
"6202",72040,"Sannicandro di Bari",999,4884,4634,9518
"6203",71049,"San Nicandro Garganico",999,6518,7072,13590
"6204",75070,"Sannicola",999,2679,2878,5557
"6205",78125,"San Nicola Arcella",999,992,981,1973
"6206",64085,"San Nicola Baronia",999,380,396,776
"6207",102035,"San Nicola da Crissa",999,616,588,1204
"6208",101021,"San Nicola dell'Alto",999,350,345,695
"6209",61078,"San Nicola la Strada",999,10886,11211,22097
"6210",62067,"San Nicola Manfredi",999,1708,1750,3458
"6211",95046,"San Nicolò d'Arcidano",999,1207,1249,2456
"6212",25046,"San Nicolò di Comelico",999,193,191,384
"6213",111064,"San Nicolò Gerrei",999,375,352,727
"6214",74015,"San Pancrazio Salentino",999,4413,4717,9130
"6215",21084,"San Pancrazio/St. Pankraz",999,803,736,1539
"6216",17138,"San Paolo",999,2228,2215,4443
"6217",76020,"San Paolo Albanese",999,97,118,215
"6218",63069,"San Paolo Bel Sito",999,1667,1703,3370
"6219",16189,"San Paolo d'Argon",999,2953,2950,5903
"6220",71050,"San Paolo di Civitate",999,2684,2738,5422
"6221",42042,"San Paolo di Jesi",999,434,456,890
"6222",5101,"San Paolo Solbrito",999,582,584,1166
"6223",16190,"San Pellegrino Terme",999,2244,2403,4647
"6224",31021,"San Pier d'Isonzo",999,996,947,1943
"6225",83080,"San Pier Niceto",999,1275,1308,2583
"6226",83081,"San Piero Patti",999,1233,1360,2593
"6227",30103,"San Pietro al Natisone",999,1036,1050,2086
"6228",65125,"San Pietro al Tanagro",999,794,854,1648
"6229",79114,"San Pietro a Maida",999,1885,1919,3804
"6230",79115,"San Pietro Apostolo",999,733,767,1500
"6231",94043,"San Pietro Avellana",999,196,214,410
"6232",87044,"San Pietro Clarenza",999,4124,4215,8339
"6233",25047,"San Pietro di Cadore",999,756,715,1471
"6234",80075,"San Pietro di Caridà",999,446,514,960
"6235",26073,"San Pietro di Feletto",999,2459,2658,5117
"6236",23075,"San Pietro di Morubio",999,1605,1463,3068
"6237",78126,"San Pietro in Amantea",999,239,230,469
"6238",23076,"San Pietro in Cariano",999,6261,6739,13000
"6239",37055,"San Pietro in Casale",999,6459,6494,12953
"6240",33041,"San Pietro in Cerro",999,384,380,764
"6241",61079,"San Pietro Infine",999,400,404,804
"6242",28078,"San Pietro in Gu",999,2056,2080,4136
"6243",78127,"San Pietro in Guarano",999,1662,1674,3336
"6244",75071,"San Pietro in Lama",999,1592,1783,3375
"6245",3135,"San Pietro Mosezzo",999,1014,977,1991
"6246",24094,"San Pietro Mussolino",999,789,731,1520
"6247",1250,"San Pietro Val Lemina",999,726,732,1458
"6248",74016,"San Pietro Vernotico",999,6268,6736,13004
"6249",28079,"San Pietro Viminario",999,1526,1477,3003
"6250",66088,"San Pio delle Camere",999,327,322,649
"6251",58096,"San Polo dei Cavalieri",999,1415,1360,2775
"6252",35038,"San Polo d'Enza",999,3039,3100,6139
"6253",26074,"San Polo di Piave",999,2487,2362,4849
"6254",70071,"San Polo Matese",999,233,219,452
"6255",1251,"San Ponso",999,117,120,237
"6256",36038,"San Possidonio",999,1744,1757,3501
"6257",61080,"San Potito Sannitico",999,955,998,1953
"6258",64086,"San Potito Ultra",999,705,762,1467
"6259",61081,"San Prisco",999,5794,6362,12156
"6260",80076,"San Procopio",999,236,243,479
"6261",36039,"San Prospero",999,3122,3038,6160
"6262",52030,"San Quirico d'Orcia",999,1268,1332,2600
"6263",93040,"San Quirino",999,2121,2156,4277
"6264",1252,"San Raffaele Cimena",999,1557,1589,3146
"6265",8055,"Sanremo",999,25431,27608,53039
"6266",80077,"San Roberto",999,762,754,1516
"6267",98049,"San Rocco al Porto",999,1660,1722,3382
"6268",46027,"San Romano in Garfagnana",999,640,684,1324
"6269",65126,"San Rufo",999,797,800,1597
"6270",83082,"San Salvatore di Fitalia",999,510,609,1119
"6271",6154,"San Salvatore Monferrato",999,1995,2023,4018
"6272",62068,"San Salvatore Telesino",999,1911,1954,3865
"6273",69083,"San Salvo",999,9898,9891,19789
"6274",63070,"San Sebastiano al Vesuvio",999,4115,4511,8626
"6275",6155,"San Sebastiano Curone",999,257,295,552
"6276",1253,"San Sebastiano da Po",999,952,940,1892
"6277",1254,"San Secondo di Pinerolo",999,1808,1839,3647
"6278",34033,"San Secondo Parmense",999,2919,2954,5873
"6279",51034,"Sansepolcro",999,7435,7714,15149
"6280",76078,"San Severino Lucano",999,666,683,1349
"6281",43047,"San Severino Marche",999,5815,6078,11893
"6282",71051,"San Severo",999,24155,25019,49174
"6283",13248,"San Siro",999,832,844,1676
"6284",64087,"San Sossio Baronia",999,726,760,1486
"6285",79116,"San Sostene",999,736,691,1427
"6286",78128,"San Sosti",999,946,910,1856
"6287",111065,"San Sperate",999,4265,4222,8487
"6288",27036,"San Stino di Livenza",999,6318,6410,12728
"6289",16191,"Santa Brigida",999,256,260,516
"6290",78129,"Santa Caterina Albanese",999,552,561,1113
"6291",79117,"Santa Caterina dello Ionio",999,949,974,1923
"6292",85017,"Santa Caterina Villarmosa",999,2145,2433,4578
"6293",75072,"Santa Cesarea Terme",999,1318,1494,2812
"6294",80078,"Santa Cristina d'Aspromonte",999,376,361,737
"6295",18139,"Santa Cristina e Bissone",999,932,890,1822
"6296",82066,"Santa Cristina Gela",999,512,481,993
"6297",21085,"Santa Cristina Valgardena/St. Christina in Gröden",999,991,1026,2017
"6298",88010,"Santa Croce Camerina",999,5915,5240,11155
"6299",62069,"Santa Croce del Sannio",999,431,428,859
"6300",70072,"Santa Croce di Magliano",999,1906,2012,3918
"6301",50033,"Santa Croce sull'Arno",999,7490,7300,14790
"6302",111068,"Santadi",999,1521,1583,3104
"6303",78130,"Santa Domenica Talao",999,569,562,1131
"6304",83083,"Santa Domenica Vittoria",999,426,427,853
"6305",84037,"Santa Elisabetta",999,1079,1105,2184
"6306",53022,"Santa Fiora",999,1217,1279,2496
"6307",82067,"Santa Flavia",999,5394,5641,11035
"6308",94044,"Sant'Agapito",999,686,666,1352
"6309",37056,"Sant'Agata Bolognese",999,3684,3659,7343
"6310",62070,"Sant'Agata de' Goti",999,5052,5178,10230
"6311",80079,"Sant'Agata del Bianco",999,280,281,561
"6312",78131,"Sant'Agata di Esaro",999,856,810,1666
"6313",83084,"Sant'Agata di Militello",999,5655,6278,11933
"6314",71052,"Sant'Agata di Puglia",999,881,913,1794
"6315",99026,"Sant'Agata Feltria",999,982,979,1961
"6316",6156,"Sant'Agata Fossili",999,178,184,362
"6317",87045,"Sant'Agata li Battiati",999,4283,4988,9271
"6318",39017,"Sant'Agata sul Santerno",999,1398,1451,2849
"6319",18140,"Santa Giuletta",999,761,800,1561
"6320",95047,"Santa Giusta",999,2301,2301,4602
"6321",25048,"Santa Giustina",999,3185,3403,6588
"6322",28080,"Santa Giustina in Colle",999,3603,3529,7132
"6323",63071,"Sant'Agnello",999,4163,4443,8606
"6324",4211,"Sant'Albano Stura",999,1241,1152,2393
"6325",18141,"Sant'Alessio con Vialone",999,531,506,1037
"6326",80080,"Sant'Alessio in Aspromonte",999,166,159,325
"6327",83085,"Sant'Alessio Siculo",999,746,804,1550
"6328",87046,"Sant'Alfio",999,728,786,1514
"6329",50034,"Santa Luce",999,802,817,1619
"6330",83086,"Santa Lucia del Mela",999,2166,2208,4374
"6331",26075,"Santa Lucia di Piave",999,4593,4547,9140
"6332",64088,"Santa Lucia di Serino",999,655,703,1358
"6333",84038,"Santa Margherita di Belice",999,2903,3055,5958
"6334",18142,"Santa Margherita di Staffora",999,231,205,436
"6335",10054,"Santa Margherita Ligure",999,3958,4494,8452
"6336",50035,"Santa Maria a Monte",999,6618,6764,13382
"6337",61082,"Santa Maria a Vico",999,6969,7343,14312
"6338",61083,"Santa Maria Capua Vetere",999,15394,16689,32083
"6339",90087,"Santa Maria Coghinas",999,673,631,1304
"6340",78132,"Santa Maria del Cedro",999,2506,2587,5093
"6341",18143,"Santa Maria della Versa",999,1126,1136,2262
"6342",94045,"Santa Maria del Molise",999,346,318,664
"6343",87047,"Santa Maria di Licodia",999,3708,3822,7530
"6344",27035,"Santa Maria di Sala",999,8667,8713,17380
"6345",97074,"Santa Maria Hoè",999,1074,1037,2111
"6346",69084,"Santa Maria Imbaro",999,995,1005,2000
"6347",63090,"Santa Maria la Carità",999,5799,5935,11734
"6348",61084,"Santa Maria la Fossa",999,1275,1276,2551
"6349",30104,"Santa Maria la Longa",999,1115,1184,2299
"6350",103062,"Santa Maria Maggiore",999,631,680,1311
"6351",42043,"Santa Maria Nuova",999,1975,1979,3954
"6352",65127,"Santa Marina",999,1597,1629,3226
"6353",83087,"Santa Marina Salina",999,448,410,858
"6354",58097,"Santa Marinella",999,8955,9516,18471
"6355",1255,"Sant'Ambrogio di Torino",999,2271,2285,4556
"6356",23077,"Sant'Ambrogio di Valpolicella",999,5849,6059,11908
"6357",60065,"Sant'Ambrogio sul Garigliano",999,448,424,872
"6358",61085,"San Tammaro",999,2890,2892,5782
"6359",63072,"Sant'Anastasia",999,12774,13413,26187
"6360",54045,"Sant'Anatolia di Narco",999,259,228,487
"6361",79118,"Sant'Andrea Apostolo dello Ionio",999,854,813,1667
"6362",60066,"Sant'Andrea del Garigliano",999,627,645,1272
"6363",64089,"Sant'Andrea di Conza",999,708,706,1414
"6364",111069,"Sant'Andrea Frius",999,856,808,1664
"6365",62071,"Sant'Angelo a Cupolo",999,1995,2029,4024
"6366",65128,"Sant'Angelo a Fasanella",999,230,259,489
"6367",64090,"Sant'Angelo all'Esca",999,359,356,715
"6368",64091,"Sant'Angelo a Scala",999,411,303,714
"6369",61086,"Sant'Angelo d'Alife",999,994,1071,2065
"6370",64092,"Sant'Angelo dei Lombardi",999,1930,1852,3782
"6371",94046,"Sant'Angelo del Pesco",999,164,158,322
"6372",83088,"Sant'Angelo di Brolo",999,1332,1390,2722
"6373",28082,"Sant'Angelo di Piove di Sacco",999,3614,3673,7287
"6374",43048,"Sant'Angelo in Pontano",999,598,665,1263
"6375",41057,"Sant'Angelo in Vado",999,1956,1933,3889
"6376",76079,"Sant'Angelo Le Fratte",999,647,646,1293
"6377",70073,"Sant'Angelo Limosano",999,145,153,298
"6378",98050,"Sant'Angelo Lodigiano",999,6736,6713,13449
"6379",18144,"Sant'Angelo Lomellina",999,405,394,799
"6380",84039,"Sant'Angelo Muxaro",999,566,602,1168
"6381",58098,"Sant'Angelo Romano",999,2504,2479,4983
"6382",81019,"Santa Ninfa",999,2293,2435,4728
"6383",111070,"Sant'Anna Arresi",999,1345,1292,2637
"6384",23078,"Sant'Anna d'Alfaedo",999,1389,1212,2601
"6385",63073,"Sant'Antimo",999,15866,16463,32329
"6386",111071,"Sant'Antioco",999,5182,5388,10570
"6387",1256,"Sant'Antonino di Susa",999,1966,2124,4090
"6388",63074,"Sant'Antonio Abate",999,9426,9546,18972
"6389",90085,"Sant'Antonio di Gallura",999,708,723,1431
"6390",64093,"Santa Paolina",999,571,588,1159
"6391",60067,"Sant'Apollinare",999,881,932,1813
"6392",76080,"Sant'Arcangelo",999,2961,2997,5958
"6393",99018,"Santarcangelo di Romagna",999,10847,11407,22254
"6394",62078,"Sant'Arcangelo Trimonte",999,230,233,463
"6395",61087,"Sant'Arpino",999,7536,7577,15113
"6396",65129,"Sant'Arsenio",999,1272,1369,2641
"6397",101022,"Santa Severina",999,925,958,1883
"6398",40043,"Santa Sofia",999,1978,2049,4027
"6399",78133,"Santa Sofia d'Epiro",999,1027,1096,2123
"6400",83089,"Santa Teresa di Riva",999,4437,4829,9266
"6401",90063,"Santa Teresa Gallura",999,2529,2515,5044
"6402",87048,"Santa Venerina",999,4112,4314,8426
"6403",4212,"Santa Vittoria d'Alba",999,1461,1436,2897
"6404",109036,"Santa Vittoria in Matenano",999,556,587,1143
"6405",67038,"Sant'Egidio alla Vibrata",999,4822,4974,9796
"6406",65130,"Sant'Egidio del Monte Albino",999,4301,4449,8750
"6407",28083,"Sant'Elena",999,1232,1284,2516
"6408",94047,"Sant'Elena Sannita",999,165,123,288
"6409",70074,"Sant'Elia a Pianisi",999,735,790,1525
"6410",60068,"Sant'Elia Fiumerapido",999,2819,2839,5658
"6411",109037,"Sant'Elpidio a Mare",999,8179,8326,16505
"6412",66089,"Sante Marie",999,551,531,1082
"6413",1257,"Santena",999,5151,5329,10480
"6414",83090,"San Teodoro",999,598,653,1251
"6415",90092,"San Teodoro",999,2574,2534,5108
"6416",72041,"Santeramo in Colle",999,12714,13021,25735
"6417",68037,"Sant'Eufemia a Maiella",999,136,117,253
"6418",80081,"Sant'Eufemia d'Aspromonte",999,1801,1879,3680
"6419",69085,"Sant'Eusanio del Sangro",999,1100,1152,2252
"6420",66090,"Sant'Eusanio Forconese",999,184,182,366
"6421",2133,"Santhià",999,3886,4159,8045
"6422",59026,"Santi Cosma e Damiano",999,3355,3486,6841
"6423",80082,"Sant'Ilario dello Ionio",999,680,668,1348
"6424",35039,"Sant'Ilario d'Enza",999,5612,5778,11390
"6425",41058,"Sant'Ippolito",999,731,734,1465
"6426",10055,"Sant'Olcese",999,2753,2808,5561
"6427",25049,"San Tomaso Agordino",999,301,297,598
"6428",65131,"Santomenna",999,201,186,387
"6429",67039,"Sant'Omero",999,2496,2672,5168
"6430",16252,"Sant'Omobono Terme",999,1961,1935,3896
"6431",102036,"Sant'Onofrio",999,1373,1372,2745
"6432",60069,"Santopadre",999,590,578,1168
"6433",58099,"Sant'Oreste",999,1745,1700,3445
"6434",24095,"Santorso",999,2770,2820,5590
"6435",22168,"Sant'Orsola Terme",999,562,542,1104
"6436",8056,"Santo Stefano al Mare",999,999,1005,2004
"6437",4213,"Santo Stefano Belbo",999,1879,1884,3763
"6438",10056,"Santo Stefano d'Aveto",999,502,480,982
"6439",64095,"Santo Stefano del Sole",999,1021,1037,2058
"6440",25050,"Santo Stefano di Cadore",999,1124,1196,2320
"6441",83091,"Santo Stefano di Camastra",999,2098,2253,4351
"6442",11026,"Santo Stefano di Magra",999,5076,5040,10116
"6443",78134,"Santo Stefano di Rogliano",999,873,876,1749
"6444",66091,"Santo Stefano di Sessanio",999,51,59,110
"6445",80083,"Santo Stefano in Aspromonte",999,538,488,1026
"6446",98051,"Santo Stefano Lodigiano",999,929,914,1843
"6447",84040,"Santo Stefano Quisquina",999,1930,2068,3998
"6448",4214,"Santo Stefano Roero",999,654,674,1328
"6449",15200,"Santo Stefano Ticino",999,2469,2548,5017
"6450",95049,"Santu Lussurgiu",999,1108,1090,2198
"6451",28084,"Sant'Urbano",999,949,950,1899
"6452",68038,"San Valentino in Abruzzo Citeriore",999,860,947,1807
"6453",65132,"San Valentino Torio",999,5476,5440,10916
"6454",55030,"San Venanzo",999,1119,1039,2158
"6455",26076,"San Vendemiano",999,4830,5004,9834
"6456",95050,"San Vero Milis",999,1201,1211,2412
"6457",49018,"San Vincenzo",999,3030,3376,6406
"6458",78135,"San Vincenzo La Costa",999,971,993,1964
"6459",66092,"San Vincenzo Valle Roveto",999,1010,1066,2076
"6460",63075,"San Vitaliano",999,3242,3369,6611
"6461",111066,"San Vito",999,1715,1706,3421
"6462",93041,"San Vito al Tagliamento",999,7462,7769,15231
"6463",30105,"San Vito al Torre",999,618,600,1218
"6464",69086,"San Vito Chietino",999,2563,2603,5166
"6465",74017,"San Vito dei Normanni",999,8671,9266,17937
"6466",25051,"San Vito di Cadore",999,925,1006,1931
"6467",30106,"San Vito di Fagagna",999,820,848,1668
"6468",24096,"San Vito di Leguzzano",999,1760,1784,3544
"6469",81020,"San Vito Lo Capo",999,2402,2399,4801
"6470",58100,"San Vito Romano",999,1584,1478,3062
"6471",79122,"San Vito sullo Ionio",999,759,813,1572
"6472",60070,"San Vittore del Lazio",999,1178,1175,2353
"6473",15201,"San Vittore Olona",999,4075,4266,8341
"6474",65133,"Sanza",999,1191,1147,2338
"6475",22169,"Sanzeno",999,470,457,927
"6476",23079,"San Zeno di Montagna",999,750,716,1466
"6477",17173,"San Zeno Naviglio",999,2312,2360,4672
"6478",15202,"San Zenone al Lambro",999,2285,2188,4473
"6479",18145,"San Zenone al Po",999,292,280,572
"6480",26077,"San Zenone degli Ezzelini",999,3770,3541,7311
"6481",28085,"Saonara",999,5228,5314,10542
"6482",83092,"Saponara",999,1791,1879,3670
"6483",30189,"Sappada",999,653,658,1311
"6484",65134,"Sapri",999,3016,3354,6370
"6485",78136,"Saracena",999,1671,1692,3363
"6486",58101,"Saracinesco",999,95,76,171
"6487",24097,"Sarcedo",999,2629,2652,5281
"6488",76081,"Sarconi",999,733,693,1426
"6489",111072,"Sardara",999,1869,1904,3773
"6490",6157,"Sardigliano",999,179,197,376
"6491",24098,"Sarego",999,3419,3356,6775
"6492",21086,"Sarentino/Sarntal",999,3636,3580,7216
"6493",6158,"Sarezzano",999,549,549,1098
"6494",17174,"Sarezzo",999,6551,6659,13210
"6495",33042,"Sarmato",999,1490,1470,2960
"6496",26078,"Sarmede",999,1497,1481,2978
"6497",43049,"Sarnano",999,1512,1542,3054
"6498",16193,"Sarnico",999,3323,3535,6858
"6499",65135,"Sarno",999,15147,15489,30636
"6500",22170,"Sarnonico",999,398,391,789
"6501",12119,"Saronno",999,18354,20237,38591
"6502",7066,"Sarre",999,2312,2482,4794
"6503",92066,"Sarroch",999,2503,2498,5001
"6504",40044,"Sarsina",999,1662,1683,3345
"6505",52031,"Sarteano",999,2127,2353,4480
"6506",18146,"Sartirana Lomellina",999,723,774,1497
"6507",91077,"Sarule",999,729,767,1496
"6508",11027,"Sarzana",999,10542,11232,21774
"6509",65136,"Sassano",999,2278,2379,4657
"6510",90064,"Sassari",999,58269,62606,120875
"6511",9055,"Sassello",999,855,823,1678
"6512",49019,"Sassetta",999,224,248,472
"6513",62072,"Sassinoro",999,314,320,634
"6514",41071,"Sassocorvaro Auditore",999,2485,2431,4916
"6515",76082,"Sasso di Castalda",999,376,349,725
"6516",99031,"Sassofeltrio",999,656,716,1372
"6517",42044,"Sassoferrato",999,3328,3495,6823
"6518",37057,"Sasso Marconi",999,7168,7698,14866
"6519",36040,"Sassuolo",999,20217,20797,41014
"6520",79123,"Satriano",999,1646,1726,3372
"6521",76083,"Satriano di Lucania",999,1191,1097,2288
"6522",30107,"Sauris",999,190,202,392
"6523",1258,"Sauze di Cesana",999,127,101,228
"6524",1259,"Sauze d'Oulx",999,534,490,1024
"6525",73026,"Sava",999,7398,7825,15223
"6526",101023,"Savelli",999,528,505,1033
"6527",63076,"Saviano",999,7816,8130,15946
"6528",4215,"Savigliano",999,10622,11145,21767
"6529",64096,"Savignano Irpino",999,526,497,1023
"6530",36041,"Savignano sul Panaro",999,4788,4803,9591
"6531",40045,"Savignano sul Rubicone",999,8883,9071,17954
"6532",10057,"Savignone",999,1482,1518,3000
"6533",17175,"Saviore dell'Adamello",999,389,399,788
"6534",83093,"Savoca",999,826,889,1715
"6535",30108,"Savogna",999,187,165,352
"6536",31022,"Savogna d'Isonzo",999,878,819,1697
"6537",76084,"Savoia di Lucania",999,509,481,990
"6538",9056,"Savona",999,27767,30853,58620
"6539",68039,"Scafa",999,1666,1795,3461
"6540",65137,"Scafati",999,23451,24489,47940
"6541",4216,"Scagnello",999,76,96,172
"6542",65138,"Scala",999,773,724,1497
"6543",78137,"Scala Coeli",999,374,404,778
"6544",18147,"Scaldasole",999,424,427,851
"6545",78138,"Scalea",999,5738,5689,11427
"6546",1260,"Scalenghe",999,1633,1575,3208
"6547",83094,"Scaletta Zanclea",999,878,967,1845
"6548",64097,"Scampitella",999,495,521,1016
"6549",101024,"Scandale",999,1408,1433,2841
"6550",35040,"Scandiano",999,12556,13321,25877
"6551",48041,"Scandicci",999,23673,25730,49403
"6552",19092,"Scandolara Ravara",999,666,625,1291
"6553",19093,"Scandolara Ripa d'Oglio",999,270,239,509
"6554",57064,"Scandriglia",999,1749,1498,3247
"6555",66093,"Scanno",999,822,873,1695
"6556",95051,"Scano di Montiferro",999,681,707,1388
"6557",53023,"Scansano",999,2279,2058,4337
"6558",77031,"Scanzano Jonico",999,3791,3728,7519
"6559",16194,"Scanzorosciate",999,4868,5065,9933
"6560",94048,"Scapoli",999,295,293,588
"6561",53024,"Scarlino",999,1888,1861,3749
"6562",1261,"Scarmagno",999,381,407,788
"6563",4217,"Scarnafigi",999,1082,1023,2105
"6564",48053,"Scarperia e San Piero",999,5929,6050,11979
"6565",21087,"Scena/Schenna",999,1524,1501,3025
"6566",69087,"Scerni",999,1444,1502,2946
"6567",54046,"Scheggia e Pascelupo",999,619,626,1245
"6568",54047,"Scheggino",999,225,211,436
"6569",69088,"Schiavi di Abruzzo",999,299,342,641
"6570",24099,"Schiavon",999,1339,1259,2598
"6571",13211,"Schignano",999,458,421,879
"6572",16195,"Schilpario",999,551,564,1115
"6573",24100,"Schio",999,19121,19727,38848
"6574",20060,"Schivenoglia",999,550,521,1071
"6575",84041,"Sciacca",999,18818,19894,38712
"6576",82068,"Sciara",999,1222,1263,2485
"6577",88011,"Scicli",999,13232,13554,26786
"6578",80084,"Scido",999,379,411,790
"6579",78139,"Scigliano",999,533,577,1110
"6580",80085,"Scilla",999,2178,2298,4476
"6581",82081,"Scillato",999,275,312,587
"6582",1262,"Sciolze",999,701,718,1419
"6583",63077,"Scisciano",999,3071,3154,6225
"6584",82069,"Sclafani Bagni",999,179,190,369
"6585",66094,"Scontrone",999,285,253,538
"6586",2134,"Scopa",999,189,182,371
"6587",2135,"Scopello",999,202,163,365
"6588",66095,"Scoppito",999,1915,1876,3791
"6589",87049,"Scordia",999,8028,7995,16023
"6590",75073,"Scorrano",999,3219,3383,6602
"6591",27037,"Scorzè",999,9533,9578,19111
"6592",66096,"Scurcola Marsicana",999,1336,1334,2670
"6593",22171,"Scurelle",999,681,677,1358
"6594",5103,"Scurzolengo",999,266,253,519
"6595",8057,"Seborga",999,138,140,278
"6596",66097,"Secinaro",999,160,140,300
"6597",75074,"Seclì",999,866,953,1819
"6598",98052,"Secugnago",999,989,1015,2004
"6599",30109,"Sedegliano",999,1851,1837,3688
"6600",25053,"Sedico",999,4995,5155,10150
"6601",95052,"Sedilo",999,961,971,1932
"6602",90065,"Sedini",999,582,639,1221
"6603",15204,"Sedriano",999,6416,6434,12850
"6604",16196,"Sedrina",999,1168,1183,2351
"6605",43050,"Sefro",999,243,212,455
"6606",111073,"Segariu",999,549,554,1103
"6607",53025,"Seggiano",999,511,484,995
"6608",58102,"Segni",999,4429,4543,8972
"6609",22172,"Segonzano",999,678,679,1357
"6610",15205,"Segrate",999,17876,19212,37088
"6611",26079,"Segusino",999,918,894,1812
"6612",92068,"Selargius",999,13662,14730,28392
"6613",57065,"Selci",999,572,572,1144
"6614",111074,"Selegas",999,626,647,1273
"6615",22246,"Sella Giudicarie",999,1490,1458,2948
"6616",54048,"Sellano",999,483,481,964
"6617",17176,"Sellero",999,683,691,1374
"6618",79126,"Sellia",999,223,249,472
"6619",79127,"Sellia Marina",999,3922,3781,7703
"6620",21088,"Selva dei Molini/Mühlwald",999,722,662,1384
"6621",25054,"Selva di Cadore",999,250,249,499
"6622",23080,"Selva di Progno",999,475,422,897
"6623",21089,"Selva di Val Gardena/Wolkenstein in Gröden",999,1274,1320,2594
"6624",28086,"Selvazzano Dentro",999,11032,11876,22908
"6625",16197,"Selvino",999,1010,984,1994
"6626",90066,"Semestene",999,60,66,126
"6627",18148,"Semiana",999,102,92,194
"6628",80086,"Seminara",999,1205,1247,2452
"6629",53028,"Semproniano",999,455,523,978
"6630",15206,"Senago",999,10588,10929,21517
"6631",21118,"Senale-San Felice/Unsere Liebe Frau im Walde-St. Felix",999,409,381,790
"6632",21091,"Senales/Schnals",999,642,600,1242
"6633",95053,"Seneghe",999,811,812,1623
"6634",64098,"Senerchia",999,388,333,721
"6635",17177,"Seniga",999,741,691,1432
"6636",42045,"Senigallia",999,21199,22854,44053
"6637",95054,"Senis",999,181,205,386
"6638",76085,"Senise",999,3249,3222,6471
"6639",13212,"Senna Comasco",999,1578,1581,3159
"6640",98053,"Senna Lodigiana",999,907,896,1803
"6641",95055,"Sennariolo",999,76,77,153
"6642",90067,"Sennori",999,3388,3454,6842
"6643",111075,"Senorbì",999,2407,2389,4796
"6644",70075,"Sepino",999,968,856,1824
"6645",93042,"Sequals",999,1107,1093,2200
"6646",46028,"Seravezza",999,5931,6522,12453
"6647",111076,"Serdiana",999,1319,1323,2642
"6648",108039,"Seregno",999,21756,23253,45009
"6649",25055,"Seren del Grappa",999,1190,1130,2320
"6650",19094,"Sergnano",999,1761,1712,3473
"6651",16198,"Seriate",999,12588,12972,25560
"6652",16199,"Serina",999,1058,1000,2058
"6653",64099,"Serino",999,3430,3371,6801
"6654",17178,"Serle",999,1539,1550,3089
"6655",20061,"Sermide e Felonica",999,3590,3499,7089
"6656",59027,"Sermoneta",999,5030,4941,9971
"6657",26080,"Sernaglia della Battaglia",999,3053,3015,6068
"6658",14059,"Sernio",999,244,242,486
"6659",5104,"Serole",999,49,48,97
"6660",71053,"Serracapriola",999,1773,1836,3609
"6661",78140,"Serra d'Aiello",999,281,253,534
"6662",42046,"Serra de' Conti",999,1761,1820,3581
"6663",85018,"Serradifalco",999,2577,2877,5454
"6664",4218,"Serralunga d'Alba",999,261,247,508
"6665",6159,"Serralunga di Crea",999,252,242,494
"6666",111077,"Serramanna",999,4187,4304,8491
"6667",36042,"Serramazzoni",999,4497,4298,8795
"6668",65139,"Serramezzana",999,136,135,271
"6669",68040,"Serramonacesca",999,263,235,498
"6670",43051,"Serrapetrona",999,439,449,888
"6671",63078,"Serrara Fontana",999,1514,1556,3070
"6672",10058,"Serra Riccò",999,3733,3847,7580
"6673",102037,"Serra San Bruno",999,3144,3122,6266
"6674",42047,"Serra San Quirico",999,1235,1320,2555
"6675",41061,"Serra Sant'Abbondio",999,441,441,882
"6676",79129,"Serrastretta",999,1452,1455,2907
"6677",80087,"Serrata",999,385,395,780
"6678",20062,"Serravalle a Po",999,692,732,1424
"6679",43052,"Serravalle di Chienti",999,551,492,1043
"6680",4219,"Serravalle Langhe",999,168,153,321
"6681",47020,"Serravalle Pistoiese",999,5843,5992,11835
"6682",6160,"Serravalle Scrivia",999,2967,2938,5905
"6683",2137,"Serravalle Sesia",999,2293,2432,4725
"6684",65140,"Serre",999,1873,1807,3680
"6685",111078,"Serrenti",999,2289,2207,4496
"6686",111079,"Serri",999,297,305,602
"6687",60071,"Serrone",999,1485,1470,2955
"6688",79130,"Sersale",999,2043,2166,4209
"6689",109038,"Servigliano",999,1103,1073,2176
"6690",61088,"Sessa Aurunca",999,9938,10251,20189
"6691",65141,"Sessa Cilento",999,547,587,1134
"6692",5105,"Sessame",999,115,125,240
"6693",94049,"Sessano del Molise",999,320,359,679
"6694",11028,"Sesta Godano",999,653,609,1262
"6695",51035,"Sestino",999,584,586,1170
"6696",93043,"Sesto al Reghena",999,3172,3138,6310
"6697",12120,"Sesto Calende",999,5262,5715,10977
"6698",94050,"Sesto Campano",999,1048,1092,2140
"6699",19095,"Sesto ed Uniti",999,1620,1609,3229
"6700",48043,"Sesto Fiorentino",999,23425,25722,49147
"6701",36043,"Sestola",999,1189,1218,2407
"6702",15209,"Sesto San Giovanni",999,37902,40663,78565
"6703",21092,"Sesto/Sexten",999,920,926,1846
"6704",1263,"Sestriere",999,482,425,907
"6705",10059,"Sestri Levante",999,8204,9048,17252
"6706",92074,"Sestu",999,10437,10332,20769
"6707",15210,"Settala",999,3747,3658,7405
"6708",60072,"Settefrati",999,354,363,717
"6709",5106,"Settime",999,275,272,547
"6710",15211,"Settimo Milanese",999,9652,10283,19935
"6711",1264,"Settimo Rottaro",999,221,247,468
"6712",92075,"Settimo San Pietro",999,3457,3508,6965
"6713",1265,"Settimo Torinese",999,22238,23560,45798
"6714",1266,"Settimo Vittone",999,774,734,1508
"6715",79131,"Settingiano",999,1674,1593,3267
"6716",111080,"Setzu",999,64,61,125
"6717",111081,"Seui",999,576,562,1138
"6718",111082,"Seulo",999,407,368,775
"6719",108040,"Seveso",999,11810,12207,24017
"6720",6161,"Sezzadio",999,605,594,1199
"6721",59028,"Sezze",999,11969,11766,23735
"6722",22173,"Sfruz",999,181,182,363
"6723",32005,"Sgonico",999,986,997,1983
"6724",60073,"Sgurgola",999,1146,1221,2367
"6725",95056,"Siamaggiore",999,437,428,865
"6726",95057,"Siamanna",999,386,367,753
"6727",65142,"Siano",999,4628,4746,9374
"6728",95076,"Siapiccia",999,176,173,349
"6729",65143,"Sicignano degli Alburni",999,1494,1549,3043
"6730",84042,"Siculiana",999,2065,2094,4159
"6731",111083,"Siddi",999,279,280,559
"6732",80088,"Siderno",999,8607,8986,17593
"6733",52032,"Siena",999,24702,28309,53011
"6734",54049,"Sigillo",999,1117,1195,2312
"6735",48044,"Signa",999,9289,9693,18982
"6736",21093,"Silandro/Schlanders",999,3181,3164,6345
"6737",91083,"Silanus",999,956,992,1948
"6738",26081,"Silea",999,5097,5391,10488
"6739",90068,"Siligo",999,387,378,765
"6740",111084,"Siliqua",999,1756,1772,3528
"6741",111085,"Silius",999,543,473,1016
"6742",46037,"Sillano Giuncugnano",999,489,510,999
"6743",3138,"Sillavengo",999,280,266,546
"6744",6162,"Silvano d'Orba",999,939,952,1891
"6745",18149,"Silvano Pietra",999,314,307,621
"6746",67040,"Silvi",999,7546,7896,15442
"6747",95058,"Simala",999,147,147,294
"6748",95059,"Simaxis",999,1066,1041,2107
"6749",102038,"Simbario",999,463,466,929
"6750",79133,"Simeri Crichi",999,2353,2367,4720
"6751",83095,"Sinagra",999,1210,1252,2462
"6752",52033,"Sinalunga",999,5836,6180,12016
"6753",91084,"Sindia",999,752,834,1586
"6754",95060,"Sini",999,277,224,501
"6755",4220,"Sinio",999,243,239,482
"6756",91085,"Siniscola",999,5600,5535,11135
"6757",92080,"Sinnai",999,8614,8657,17271
"6758",80089,"Sinopoli",999,938,924,1862
"6759",89017,"Siracusa",999,56932,59119,116051
"6760",64100,"Sirignano",999,1394,1443,2837
"6761",95061,"Siris",999,125,103,228
"6762",17179,"Sirmione",999,3986,4326,8312
"6763",42048,"Sirolo",999,1945,2140,4085
"6764",97075,"Sirone",999,1155,1189,2344
"6765",97076,"Sirtori",999,1392,1378,2770
"6766",34049,"Sissa Trecasali",999,3909,3998,7907
"6767",111086,"Siurgus Donigala",999,899,925,1824
"6768",18150,"Siziano",999,3325,3348,6673
"6769",3139,"Sizzano",999,665,702,1367
"6770",21094,"Sluderno/Schluderns",999,934,928,1862
"6771",109039,"Smerillo",999,172,159,331
"6772",23081,"Soave",999,3567,3624,7191
"6773",30110,"Socchieve",999,456,416,872
"6774",95078,"Soddì",999,57,64,121
"6775",40046,"Sogliano al Rubicone",999,1576,1590,3166
"6776",75075,"Sogliano Cavour",999,1925,1930,3855
"6777",5107,"Soglio",999,60,69,129
"6778",17180,"Soiano del Lago",999,972,941,1913
"6779",24101,"Solagna",999,903,899,1802
"6780",89018,"Solarino",999,3715,3821,7536
"6781",15213,"Solaro",999,6984,7080,14064
"6782",39018,"Solarolo",999,2157,2263,4420
"6783",19096,"Solarolo Rainerio",999,462,467,929
"6784",95062,"Solarussa",999,1130,1120,2250
"6785",12121,"Solbiate Arno",999,1946,2063,4009
"6786",13255,"Solbiate con Cagno",999,2288,2393,4681
"6787",12122,"Solbiate Olona",999,2689,2733,5422
"6788",8058,"Soldano",999,489,485,974
"6789",111087,"Soleminis",999,947,927,1874
"6790",6163,"Solero",999,788,788,1576
"6791",28087,"Solesino",999,3337,3384,6721
"6792",75076,"Soleto",999,2475,2671,5146
"6793",20063,"Solferino",999,1295,1302,2597
"6794",36044,"Soliera",999,7728,7870,15598
"6795",34035,"Solignano",999,886,803,1689
"6796",64101,"Solofra",999,5931,6104,12035
"6797",6164,"Solonghello",999,98,96,194
"6798",62073,"Solopaca",999,1616,1828,3444
"6799",16200,"Solto Collina",999,904,891,1795
"6800",16251,"Solza",999,994,981,1975
"6801",98054,"Somaglia",999,1906,1882,3788
"6802",4221,"Somano",999,156,148,304
"6803",23082,"Sommacampagna",999,7204,7233,14437
"6804",12123,"Somma Lombardo",999,8734,9050,17784
"6805",4222,"Sommariva del Bosco",999,3109,3171,6280
"6806",4223,"Sommariva Perno",999,1303,1374,2677
"6807",85019,"Sommatino",999,3013,3326,6339
"6808",63079,"Somma Vesuviana",999,16425,17197,33622
"6809",18151,"Sommo",999,576,566,1142
"6810",23083,"Sona",999,8691,8911,17602
"6811",19097,"Soncino",999,3739,3780,7519
"6812",14060,"Sondalo",999,1889,1971,3860
"6813",14061,"Sondrio",999,10027,11217,21244
"6814",16201,"Songavazzo",999,371,346,717
"6815",17181,"Sonico",999,599,589,1188
"6816",59029,"Sonnino",999,3645,3722,7367
"6817",60074,"Sora",999,12222,12603,24825
"6818",22176,"Soraga di Fassa",999,374,344,718
"6819",34036,"Soragna",999,2390,2364,4754
"6820",53026,"Sorano",999,1477,1544,3021
"6821",34051,"Sorbolo Mezzani",999,6466,6523,12989
"6822",79134,"Sorbo San Basile",999,364,374,738
"6823",64102,"Sorbo Serpico",999,266,257,523
"6824",96063,"Sordevolo",999,616,654,1270
"6825",98055,"Sordio",999,1740,1691,3431
"6826",19098,"Soresina",999,4499,4563,9062
"6827",23084,"Sorgà",999,1506,1418,2924
"6828",91086,"Sorgono",999,733,730,1463
"6829",10060,"Sori",999,1919,2059,3978
"6830",102039,"Sorianello",999,562,531,1093
"6831",102040,"Soriano Calabro",999,1143,1168,2311
"6832",56048,"Soriano nel Cimino",999,3894,4023,7917
"6833",13216,"Sorico",999,623,603,1226
"6834",3140,"Soriso",999,354,367,721
"6835",16202,"Sorisole",999,4415,4428,8843
"6836",13217,"Sormano",999,350,296,646
"6837",95063,"Sorradile",999,162,174,336
"6838",63080,"Sorrento",999,7341,7956,15297
"6839",90069,"Sorso",999,7275,7118,14393
"6840",89019,"Sortino",999,4040,4107,8147
"6841",19099,"Sospiro",999,1564,1478,3042
"6842",25056,"Sospirolo",999,1549,1579,3128
"6843",24102,"Sossano",999,2111,2027,4138
"6844",96064,"Sostegno",999,360,373,733
"6845",16203,"Sotto il Monte Giovanni XXIII",999,2195,2173,4368
"6846",22177,"Sover",999,405,381,786
"6847",79137,"Soverato",999,3982,4566,8548
"6848",16204,"Sovere",999,2622,2684,5306
"6849",79138,"Soveria Mannelli",999,1334,1459,2793
"6850",79139,"Soveria Simeri",999,699,744,1443
"6851",25057,"Soverzene",999,174,185,359
"6852",52034,"Sovicille",999,4801,5123,9924
"6853",108041,"Sovico",999,4084,4233,8317
"6854",24103,"Sovizzo",999,3664,3758,7422
"6855",25058,"Sovramonte",999,660,662,1322
"6856",3141,"Sozzago",999,537,574,1111
"6857",83096,"Spadafora",999,2242,2406,4648
"6858",102041,"Spadola",999,399,392,791
"6859",61089,"Sparanise",999,3524,3695,7219
"6860",1267,"Sparone",999,451,474,925
"6861",75077,"Specchia",999,2192,2353,4545
"6862",54050,"Spello",999,3982,4299,8281
"6863",86017,"Sperlinga",999,335,340,675
"6864",59030,"Sperlonga",999,1519,1522,3041
"6865",64103,"Sperone",999,1758,1842,3600
"6866",18152,"Spessa",999,268,282,550
"6867",78142,"Spezzano Albanese",999,3247,3296,6543
"6868",78143,"Spezzano della Sila",999,2128,2096,4224
"6869",22179,"Spiazzo",999,627,639,1266
"6870",6165,"Spigno Monferrato",999,454,447,901
"6871",59031,"Spigno Saturnia",999,1389,1480,2869
"6872",36045,"Spilamberto",999,6446,6483,12929
"6873",93044,"Spilimbergo",999,5761,6032,11793
"6874",102042,"Spilinga",999,683,678,1361
"6875",19100,"Spinadesco",999,696,736,1432
"6876",110008,"Spinazzola",999,2881,3011,5892
"6877",27038,"Spinea",999,13290,14430,27720
"6878",19101,"Spineda",999,292,309,601
"6879",70076,"Spinete",999,589,585,1174
"6880",44071,"Spinetoli",999,3536,3657,7193
"6881",6166,"Spineto Scrivia",999,184,181,365
"6882",19102,"Spino d'Adda",999,3502,3503,7005
"6883",16205,"Spinone al Lago",999,495,498,993
"6884",76086,"Spinoso",999,632,665,1297
"6885",16206,"Spirano",999,2839,2805,5644
"6886",54051,"Spoleto",999,17530,18656,36186
"6887",68041,"Spoltore",999,9316,9756,19072
"6888",75078,"Spongano",999,1644,1786,3430
"6889",22180,"Spormaggiore",999,669,579,1248
"6890",22181,"Sporminore",999,356,362,718
"6891",9057,"Spotorno",999,1628,1769,3397
"6892",26082,"Spresiano",999,6119,6231,12350
"6893",14062,"Spriana",999,42,41,83
"6894",79142,"Squillace",999,1788,1787,3575
"6895",75079,"Squinzano",999,6441,6936,13377
"6896",42049,"Staffolo",999,1047,1058,2105
"6897",19103,"Stagno Lombardo",999,729,705,1434
"6898",80090,"Staiti",999,86,88,174
"6899",79143,"Stalettì",999,1206,1161,2367
"6900",28088,"Stanghella",999,2043,2081,4124
"6901",31023,"Staranzano",999,3537,3602,7139
"6902",73029,"Statte",999,6204,6596,12800
"6903",6167,"Stazzano",999,1122,1161,2283
"6904",46030,"Stazzema",999,1438,1430,2868
"6905",13218,"Stazzona",999,307,292,599
"6906",102043,"Stefanaconi",999,1137,1147,2284
"6907",9058,"Stella",999,1494,1477,2971
"6908",65144,"Stella Cilento",999,314,316,630
"6909",9059,"Stellanello",999,434,414,848
"6910",21095,"Stelvio/Stilfs",999,592,538,1130
"6911",22182,"Stenico",999,619,556,1175
"6912",75080,"Sternatia",999,986,1133,2119
"6913",16207,"Stezzano",999,6741,6912,13653
"6914",29045,"Stienta",999,1535,1560,3095
"6915",77027,"Stigliano",999,1667,1846,3513
"6916",80091,"Stignano",999,597,568,1165
"6917",80092,"Stilo",999,1195,1142,2337
"6918",57066,"Stimigliano",999,1101,1091,2192
"6919",90089,"Stintino",999,786,752,1538
"6920",65145,"Stio",999,384,392,776
"6921",71054,"Stornara",999,2912,2861,5773
"6922",71055,"Stornarella",999,2634,2681,5315
"6923",22183,"Storo",999,2184,2293,4477
"6924",27039,"Stra",999,3701,3855,7556
"6925",18153,"Stradella",999,5583,5878,11461
"6926",1268,"Strambinello",999,118,131,249
"6927",1269,"Strambino",999,2928,3131,6059
"6928",60075,"Strangolagalli",999,1107,1170,2277
"6929",30111,"Stregna",999,152,132,284
"6930",22184,"Strembo",999,296,286,582
"6931",103064,"Stresa",999,2207,2450,4657
"6932",6168,"Strevi",999,977,977,1954
"6933",63081,"Striano",999,4533,4478,9011
"6934",96065,"Strona",999,458,481,939
"6935",55031,"Stroncone",999,2332,2285,4617
"6936",101025,"Strongoli",999,2994,3165,6159
"6937",2142,"Stroppiana",999,577,602,1179
"6938",4224,"Stroppo",999,55,55,110
"6939",16208,"Strozza",999,571,547,1118
"6940",64104,"Sturno",999,1343,1393,2736
"6941",18154,"Suardi",999,284,293,577
"6942",51037,"Subbiano",999,3202,3126,6328
"6943",58103,"Subiaco",999,4227,4306,8533
"6944",61090,"Succivo",999,4375,4423,8798
"6945",97077,"Sueglio",999,78,68,146
"6946",111088,"Suelli",999,542,542,1084
"6947",97078,"Suello",999,843,892,1735
"6948",16209,"Suisio",999,1921,1857,3778
"6949",108042,"Sulbiate",999,2272,2246,4518
"6950",66098,"Sulmona",999,10635,11309,21944
"6951",17182,"Sulzano",999,976,965,1941
"6952",12124,"Sumirago",999,2955,3051,6006
"6953",64105,"Summonte",999,750,743,1493
"6954",95087,"Suni",999,471,508,979
"6955",3143,"Suno",999,1313,1365,2678
"6956",75081,"Supersano",999,2046,2085,4131
"6957",60076,"Supino",999,2263,2327,4590
"6958",75082,"Surano",999,715,796,1511
"6959",75083,"Surbo",999,7085,7492,14577
"6960",1270,"Susa",999,2797,3108,5905
"6961",26083,"Susegana",999,5889,5858,11747
"6962",20064,"Sustinente",999,951,974,1925
"6963",85020,"Sutera",999,556,606,1162
"6964",56049,"Sutri",999,3358,3392,6750
"6965",30112,"Sutrio",999,600,628,1228
"6966",49020,"Suvereto",999,1451,1482,2933
"6967",20065,"Suzzara",999,10578,10579,21157
"6968",97079,"Taceno",999,317,278,595
"6969",95064,"Tadasuni",999,66,60,126
"6970",8059,"Taggia",999,6537,7229,13766
"6971",66099,"Tagliacozzo",999,3179,3252,6431
"6972",29046,"Taglio di Po",999,3913,3953,7866
"6973",6169,"Tagliolo Monferrato",999,737,742,1479
"6974",25059,"Taibon Agordino",999,864,855,1719
"6975",12125,"Taino",999,1803,1809,3612
"6976",30113,"Taipana",999,295,273,568
"6977",99027,"Talamello",999,516,545,1061
"6978",14063,"Talamona",999,2277,2323,4600
"6979",91088,"Talana",999,457,501,958
"6980",16210,"Taleggio",999,290,229,519
"6981",51038,"Talla",999,507,482,989
"6982",30114,"Talmassons",999,1894,1927,3821
"6983",25060,"Tambre",999,656,633,1289
"6984",83097,"Taormina",999,5135,5364,10499
"6985",57067,"Tarano",999,683,703,1386
"6986",69089,"Taranta Peligna",999,153,138,291
"6987",4225,"Tarantasca",999,1123,1065,2188
"6988",73027,"Taranto",999,89657,97141,186798
"6989",30116,"Tarcento",999,4255,4587,8842
"6990",56050,"Tarquinia",999,7807,8178,15985
"6991",78145,"Tarsia",999,921,912,1833
"6992",14064,"Tartano",999,109,98,207
"6993",30117,"Tarvisio",999,2015,1929,3944
"6994",26084,"Tarzo",999,2042,2112,4154
"6995",6170,"Tassarolo",999,305,280,585
"6996",64106,"Taurano",999,709,757,1466
"6997",64107,"Taurasi",999,1058,1065,2123
"6998",80093,"Taurianova",999,7210,7578,14788
"6999",75084,"Taurisano",999,5417,5823,11240
"7000",30118,"Tavagnacco",999,6991,7638,14629
"7001",1271,"Tavagnasco",999,358,387,745
"7002",98056,"Tavazzano con Villavesco",999,2940,3024,5964
"7003",70077,"Tavenna",999,275,311,586
"7004",79146,"Taverna",999,1260,1249,2509
"7005",13222,"Tavernerio",999,2773,2863,5636
"7006",16211,"Tavernola Bergamasca",999,980,954,1934
"7007",17183,"Tavernole sul Mella",999,618,592,1210
"7008",75085,"Taviano",999,5490,5945,11435
"7009",96066,"Tavigliano",999,453,448,901
"7010",41064,"Tavoleto",999,401,430,831
"7011",41065,"Tavullia",999,4004,3931,7935
"7012",76087,"Teana",999,243,269,512
"7013",61091,"Teano",999,5443,5701,11144
"7014",65146,"Teggiano",999,3373,3657,7030
"7015",14065,"Teglio",999,2251,2274,4525
"7016",27040,"Teglio Veneto",999,1140,1113,2253
"7017",62074,"Telese Terme",999,3629,4013,7642
"7018",16212,"Telgate",999,2638,2392,5030
"7019",90080,"Telti",999,1107,1108,2215
"7020",22188,"Telve",999,942,963,1905
"7021",22189,"Telve di Sopra",999,322,298,620
"7022",90070,"Tempio Pausania",999,6566,6554,13120
"7023",17184,"Temù",999,582,569,1151
"7024",22190,"Tenna",999,528,537,1065
"7025",22191,"Tenno",999,992,1047,2039
"7026",28089,"Teolo",999,4388,4534,8922
"7027",64108,"Teora",999,727,734,1461
"7028",67041,"Teramo",999,24940,26586,51526
"7029",3144,"Terdobbiate",999,234,214,448
"7030",60077,"Terelle",999,144,143,287
"7031",21096,"Terento/Terenten",999,938,861,1799
"7032",34038,"Terenzo",999,584,563,1147
"7033",90086,"Tergu",999,288,318,606
"7034",21097,"Terlano/Terlan",999,2457,2431,4888
"7035",72043,"Terlizzi",999,12943,13099,26042
"7036",21098,"Termeno sulla strada del vino/Tramin an der Weinstraße",999,1670,1686,3356
"7037",83106,"Terme Vigliatore",999,3554,3690,7244
"7038",82070,"Termini Imerese",999,12126,12710,24836
"7039",70078,"Termoli",999,15564,16416,31980
"7040",12126,"Ternate",999,1215,1274,2489
"7041",96067,"Ternengo",999,127,129,256
"7042",55032,"Terni",999,51008,55669,106677
"7043",16213,"Terno d'Isola",999,4034,3971,8005
"7044",59032,"Terracina",999,22406,22245,44651
"7045",22193,"Terragnolo",999,371,334,705
"7046",95065,"Terralba",999,4878,4771,9649
"7047",78146,"Terranova da Sibari",999,2272,2277,4549
"7048",98057,"Terranova dei Passerini",999,470,465,935
"7049",76088,"Terranova di Pollino",999,480,523,1003
"7050",80094,"Terranova Sappo Minulio",999,221,211,432
"7051",51039,"Terranuova Bracciolini",999,5934,6081,12015
"7052",82071,"Terrasini",999,6397,6564,12961
"7053",28090,"Terrassa Padovana",999,1349,1330,2679
"7054",78147,"Terravecchia",999,276,300,576
"7055",23085,"Terrazzo",999,1075,1105,2180
"7056",22251,"Terre d'Adige",999,1579,1516,3095
"7057",38028,"Terre del Reno",999,5014,5142,10156
"7058",41070,"Terre Roveresche",999,2668,2568,5236
"7059",50036,"Terricciola",999,2158,2214,4372
"7060",6171,"Terruggia",999,419,461,880
"7061",91089,"Tertenia",999,1922,1935,3857
"7062",63082,"Terzigno",999,8701,8570,17271
"7063",6172,"Terzo",999,420,402,822
"7064",30120,"Terzo d'Aquileia",999,1315,1391,2706
"7065",22195,"Terzolas",999,310,333,643
"7066",8060,"Terzorio",999,109,111,220
"7067",22196,"Tesero",999,1505,1489,2994
"7068",21099,"Tesimo/Tisens",999,1011,1005,2016
"7069",56051,"Tessennano",999,145,138,283
"7070",9060,"Testico",999,93,90,183
"7071",91090,"Teti",999,313,276,589
"7072",111089,"Teulada",999,1658,1556,3214
"7073",61092,"Teverola",999,7365,7592,14957
"7074",24104,"Tezze sul Brenta",999,6487,6451,12938
"7075",24105,"Thiene",999,11695,12266,23961
"7076",90071,"Thiesi",999,1370,1347,2717
"7077",91091,"Tiana",999,214,218,432
"7078",19104,"Ticengo",999,220,222,442
"7079",6173,"Ticineto",999,639,677,1316
"7080",75086,"Tiggiano",999,1404,1394,2798
"7081",10061,"Tiglieto",999,234,216,450
"7082",5108,"Tigliole",999,857,858,1715
"7083",17185,"Tignale",999,560,597,1157
"7084",95088,"Tinnura",999,121,127,248
"7085",66100,"Tione degli Abruzzi",999,129,129,258
"7086",22199,"Tione di Trento",999,1821,1843,3664
"7087",14066,"Tirano",999,4267,4581,8848
"7088",21100,"Tires/Tiers",999,480,537,1017
"7089",79147,"Tiriolo",999,1758,1781,3539
"7090",21101,"Tirolo/Tirol",999,1232,1239,2471
"7091",90072,"Tissi",999,1182,1161,2343
"7092",76089,"Tito",999,3503,3552,7055
"7093",58104,"Tivoli",999,27163,28038,55201
"7094",34039,"Tizzano Val Parma",999,1110,1059,2169
"7095",35041,"Toano",999,2111,2043,4154
"7096",62075,"Tocco Caudio",999,739,738,1477
"7097",68042,"Tocco da Casauria",999,1161,1206,2367
"7098",103065,"Toceno",999,387,352,739
"7099",54052,"Todi",999,7559,8029,15588
"7100",57068,"Toffia",999,544,530,1074
"7101",9061,"Toirano",999,1328,1381,2709
"7102",43053,"Tolentino",999,8630,9130,17760
"7103",58105,"Tolfa",999,2378,2338,4716
"7104",96068,"Tollegno",999,1145,1216,2361
"7105",69090,"Tollo",999,1919,1957,3876
"7106",30121,"Tolmezzo",999,4648,5133,9781
"7107",76090,"Tolve",999,1466,1460,2926
"7108",28091,"Tombolo",999,4009,4131,8140
"7109",22200,"Ton",999,677,605,1282
"7110",91093,"Tonara",999,918,874,1792
"7111",5109,"Tonco",999,374,363,737
"7112",24106,"Tonezza del Cimone",999,255,257,512
"7113",61093,"Tora e Piccilli",999,365,380,745
"7114",78148,"Torano Castello",999,2163,2138,4301
"7115",67042,"Torano Nuovo",999,720,740,1460
"7116",17186,"Torbole Casaglia",999,3245,3196,6441
"7117",22202,"Torcegno",999,341,353,694
"7118",65147,"Torchiara",999,931,946,1877
"7119",74018,"Torchiarolo",999,2619,2648,5267
"7120",64109,"Torella dei Lombardi",999,950,1003,1953
"7121",70079,"Torella del Sannio",999,362,337,699
"7122",54053,"Torgiano",999,3247,3365,6612
"7123",7067,"Torgnon",999,300,259,559
"7124",1272,"Torino",999,407538,439388,846926
"7125",69091,"Torino di Sangro",999,1424,1449,2873
"7126",72044,"Toritto",999,3932,4077,8009
"7127",19105,"Torlino Vimercati",999,244,229,473
"7128",3146,"Tornaco",999,423,429,852
"7129",69092,"Tornareccio",999,826,816,1642
"7130",19106,"Tornata",999,231,178,409
"7131",66101,"Tornimparte",999,1412,1353,2765
"7132",13223,"Torno",999,522,545,1067
"7133",34040,"Tornolo",999,468,422,890
"7134",70080,"Toro",999,599,615,1214
"7135",91094,"Torpè",999,1410,1308,2718
"7136",65148,"Torraca",999,594,603,1197
"7137",90073,"Torralba",999,432,442,874
"7138",18155,"Torrazza Coste",999,809,788,1597
"7139",1273,"Torrazza Piemonte",999,1486,1523,3009
"7140",96069,"Torrazzo",999,106,97,203
"7141",63083,"Torre Annunziata",999,19252,20799,40051
"7142",30122,"Torreano",999,994,1041,2035
"7143",24107,"Torrebelvicino",999,2990,2850,5840
"7144",18156,"Torre Beretti e Castellaro",999,263,240,503
"7145",16214,"Torre Boldone",999,4188,4548,8736
"7146",4226,"Torre Bormida",999,87,95,182
"7147",69093,"Torrebruna",999,327,341,668
"7148",60078,"Torre Cajetani",999,670,631,1301
"7149",1274,"Torre Canavese",999,296,323,619
"7150",62076,"Torrecuso",999,1601,1613,3214
"7151",18157,"Torre d'Arese",999,491,425,916
"7152",16215,"Torre de' Busi",999,1138,1120,2258
"7153",63084,"Torre del Greco",999,38704,41389,80093
"7154",18158,"Torre de' Negri",999,157,175,332
"7155",68043,"Torre de' Passeri",999,1388,1456,2844
"7156",19107,"Torre de' Picenardi",999,1096,1059,2155
"7157",16216,"Torre de' Roveri",999,1279,1293,2572
"7158",27041,"Torre di Mosto",999,2397,2396,4793
"7159",79148,"Torre di Ruggiero",999,441,506,947
"7160",14067,"Torre di Santa Maria",999,361,368,729
"7161",18159,"Torre d'Isola",999,1232,1247,2479
"7162",28092,"Torreglia",999,2973,3056,6029
"7163",83098,"Torregrotta",999,3421,3876,7297
"7164",64110,"Torre Le Nocelle",999,619,615,1234
"7165",71056,"Torremaggiore",999,8171,8285,16456
"7166",4227,"Torre Mondovì",999,311,245,556
"7167",83108,"Torrenova",999,2198,2314,4512
"7168",65149,"Torre Orsaia",999,961,985,1946
"7169",16217,"Torre Pallavicina",999,572,550,1122
"7170",1275,"Torre Pellice",999,2192,2442,4634
"7171",4228,"Torre San Giorgio",999,350,370,720
"7172",109040,"Torre San Patrizio",999,892,922,1814
"7173",74019,"Torre Santa Susanna",999,4956,5121,10077
"7174",4229,"Torresina",999,21,26,47
"7175",82072,"Torretta",999,2151,2216,4367
"7176",18160,"Torrevecchia Pia",999,1820,1718,3538
"7177",69094,"Torrevecchia Teatina",999,2090,2120,4210
"7178",60079,"Torrice",999,2290,2389,4679
"7179",73028,"Torricella",999,2058,2062,4120
"7180",19108,"Torricella del Pizzo",999,298,281,579
"7181",57069,"Torricella in Sabina",999,647,638,1285
"7182",69095,"Torricella Peligna",999,540,576,1116
"7183",67043,"Torricella Sicura",999,1206,1211,2417
"7184",18161,"Torricella Verzate",999,403,405,808
"7185",23086,"Torri del Benaco",999,1402,1507,2909
"7186",24108,"Torri di Quartesolo",999,5817,5952,11769
"7187",10062,"Torriglia",999,1108,1135,2243
"7188",57070,"Torri in Sabina",999,633,590,1223
"7189",34041,"Torrile",999,3914,3819,7733
"7190",64111,"Torrioni",999,274,206,480
"7191",52035,"Torrita di Siena",999,3432,3536,6968
"7192",58106,"Torrita Tiberina",999,547,547,1094
"7193",91095,"Tortolì",999,5395,5581,10976
"7194",6174,"Tortona",999,12846,13696,26542
"7195",78149,"Tortora",999,2890,3084,5974
"7196",65150,"Tortorella",999,229,247,476
"7197",67044,"Tortoreto",999,5723,6129,11852
"7198",83099,"Tortorici",999,2772,2857,5629
"7199",30123,"Torviscosa",999,1269,1316,2585
"7200",17187,"Toscolano-Maderno",999,3699,3958,7657
"7201",67045,"Tossicia",999,582,636,1218
"7202",14068,"Tovo di Sant'Agata",999,314,295,609
"7203",9062,"Tovo San Giacomo",999,1241,1283,2524
"7204",82073,"Trabia",999,5391,5225,10616
"7205",12127,"Tradate",999,9376,9602,18978
"7206",95066,"Tramatza",999,468,450,918
"7207",22203,"Trambileno",999,723,750,1473
"7208",65151,"Tramonti",999,2073,2080,4153
"7209",93045,"Tramonti di Sopra",999,125,141,266
"7210",93046,"Tramonti di Sotto",999,167,166,333
"7211",76091,"Tramutola",999,1420,1458,2878
"7212",1276,"Trana",999,1849,1922,3771
"7213",110009,"Trani",999,27163,27790,54953
"7214",14069,"Traona",999,1477,1397,2874
"7215",81021,"Trapani",999,26726,28492,55218
"7216",82074,"Trappeto",999,1534,1557,3091
"7217",103066,"Trarego Viggiona",999,201,197,398
"7218",66102,"Trasacco",999,2957,2827,5784
"7219",30124,"Trasaghis",999,1027,1057,2084
"7220",103067,"Trasquera",999,87,92,179
"7221",111090,"Tratalias",999,507,480,987
"7222",18162,"Travacò Siccomario",999,2147,2293,4440
"7223",17188,"Travagliato",999,6840,7008,13848
"7224",12128,"Travedona-Monate",999,1879,2017,3896
"7225",1278,"Traversella",999,152,156,308
"7226",34042,"Traversetolo",999,4768,4862,9630
"7227",1279,"Traves",999,266,245,511
"7228",93047,"Travesio",999,900,927,1827
"7229",33043,"Travo",999,1119,1105,2224
"7230",28093,"Trebaseleghe",999,6522,6469,12991
"7231",78150,"Trebisacce",999,4187,4446,8633
"7232",63091,"Trecase",999,4161,4341,8502
"7233",87050,"Trecastagni",999,5594,5730,11324
"7234",42050,"Trecastelli",999,3823,3776,7599
"7235",3149,"Trecate",999,10465,10429,20894
"7236",76092,"Trecchina",999,1011,1129,2140
"7237",29047,"Trecenta",999,1252,1314,2566
"7238",40049,"Tredozio",999,560,560,1120
"7239",69096,"Treglio",999,848,863,1711
"7240",23087,"Tregnago",999,2484,2557,5041
"7241",43054,"Treia",999,4553,4543,9096
"7242",4230,"Treiso",999,396,366,762
"7243",87051,"Tremestieri Etneo",999,9195,10176,19371
"7244",13252,"Tremezzina",999,2448,2547,4995
"7245",17189,"Tremosine sul Garda",999,1052,1037,2089
"7246",65152,"Trentinara",999,780,784,1564
"7247",22205,"Trento",999,57897,60989,118886
"7248",61094,"Trentola Ducenta",999,10071,10441,20512
"7249",17190,"Trenzano",999,2779,2732,5511
"7250",30126,"Treppo Grande",999,825,890,1715
"7251",30191,"Treppo Ligosullo",999,344,335,679
"7252",75087,"Trepuzzi",999,6574,7251,13825
"7253",52036,"Trequanda",999,572,581,1153
"7254",45015,"Tresana",999,949,968,1917
"7255",16218,"Trescore Balneario",999,5005,4930,9935
"7256",19109,"Trescore Cremasco",999,1408,1442,2850
"7257",38030,"Tresignana",999,3357,3589,6946
"7258",14070,"Tresivio",999,1020,1020,2040
"7259",95067,"Tresnuraghes",999,491,517,1008
"7260",23088,"Trevenzuolo",999,1425,1309,2734
"7261",54054,"Trevi",999,3879,4093,7972
"7262",64112,"Trevico",999,404,423,827
"7263",16219,"Treviglio",999,15287,15808,31095
"7264",26085,"Trevignano",999,5395,5328,10723
"7265",58107,"Trevignano Romano",999,2818,3015,5833
"7266",6175,"Treville",999,129,138,267
"7267",22247,"Tre Ville",999,681,701,1382
"7268",60080,"Trevi nel Lazio",999,896,832,1728
"7269",16220,"Treviolo",999,5271,5574,10845
"7270",26086,"Treviso",999,41078,44204,85282
"7271",17191,"Treviso Bresciano",999,253,271,524
"7272",15219,"Trezzano Rosa",999,2696,2683,5379
"7273",15220,"Trezzano sul Naviglio",999,10583,11052,21635
"7274",13226,"Trezzone",999,125,114,239
"7275",15221,"Trezzo sull'Adda",999,5948,6173,12121
"7276",4231,"Trezzo Tinella",999,149,134,283
"7277",28094,"Tribano",999,2112,2092,4204
"7278",15222,"Tribiano",999,1901,1868,3769
"7279",10063,"Tribogna",999,303,283,586
"7280",77028,"Tricarico",999,2309,2394,4703
"7281",75088,"Tricase",999,8208,8790,16998
"7282",2147,"Tricerro",999,337,325,662
"7283",30127,"Tricesimo",999,3631,3940,7571
"7284",91097,"Triei",999,537,521,1058
"7285",32006,"Trieste",999,96235,103165,199400
"7286",72046,"Triggiano",999,12446,13396,25842
"7287",19110,"Trigolo",999,782,868,1650
"7288",4232,"Trinità",999,1115,1144,2259
"7289",90074,"Trinità d'Agultu e Vignola",999,1219,1146,2365
"7290",110010,"Trinitapoli",999,6710,7005,13715
"7291",2148,"Trino",999,3307,3342,6649
"7292",8061,"Triora",999,214,182,396
"7293",83100,"Tripi",999,343,405,748
"7294",6176,"Trisobbio",999,324,326,650
"7295",24110,"Trissino",999,4356,4314,8670
"7296",108043,"Triuggio",999,4386,4354,8740
"7297",70081,"Trivento",999,2165,2178,4343
"7298",60081,"Trivigliano",999,788,821,1609
"7299",30128,"Trivignano Udinese",999,753,787,1540
"7300",76093,"Trivigno",999,277,305,582
"7301",18163,"Trivolzio",999,1224,1214,2438
"7302",21102,"Trodena nel parco naturale/Truden im Naturpark",999,527,523,1050
"7303",1280,"Trofarello",999,5177,5434,10611
"7304",71058,"Troia",999,3208,3416,6624
"7305",86018,"Troina",999,4080,4343,8423
"7306",18164,"Tromello",999,1799,1872,3671
"7307",103068,"Trontano",999,857,820,1677
"7308",12129,"Tronzano Lago Maggiore",999,119,114,233
"7309",2150,"Tronzano Vercellese",999,1603,1679,3282
"7310",102044,"Tropea",999,2780,3003,5783
"7311",18165,"Trovo",999,512,487,999
"7312",15224,"Truccazzano",999,3024,2826,5850
"7313",21103,"Tubre/Taufers im Münstertal",999,463,496,959
"7314",70082,"Tufara",999,382,392,774
"7315",69097,"Tufillo",999,160,173,333
"7316",63085,"Tufino",999,1675,1697,3372
"7317",64113,"Tufo",999,387,390,777
"7318",75089,"Tuglie",999,2450,2591,5041
"7319",111091,"Tuili",999,451,465,916
"7320",90075,"Tula",999,723,704,1427
"7321",54055,"Tuoro sul Trasimeno",999,1828,1908,3736
"7322",57071,"Turania",999,133,104,237
"7323",98058,"Turano Lodigiano",999,768,747,1515
"7324",13227,"Turate",999,4908,4892,9800
"7325",15226,"Turbigo",999,3519,3587,7106
"7326",72047,"Turi",999,6328,6694,13022
"7327",111092,"Turri",999,190,183,373
"7328",31024,"Turriaco",999,1369,1401,2770
"7329",68044,"Turrivalignani",999,397,403,800
"7330",77029,"Tursi",999,2376,2374,4750
"7331",83101,"Tusa",999,1275,1268,2543
"7332",56052,"Tuscania",999,3934,4274,8208
"7333",16221,"Ubiale Clanezzo",999,671,632,1303
"7334",12130,"Uboldo",999,5481,5394,10875
"7335",83102,"Ucria",999,416,460,876
"7336",30129,"Udine",999,46453,51977,98430
"7337",75090,"Ugento",999,5809,6189,11998
"7338",75091,"Uggiano la Chiesa",999,2050,2268,4318
"7339",13228,"Uggiate-Trevano",999,2568,2668,5236
"7340",91098,"Ulassai",999,656,704,1360
"7341",95068,"Ulà Tirso",999,214,234,448
"7342",21104,"Ultimo/Ulten",999,1470,1445,2915
"7343",54056,"Umbertide",999,7958,8352,16310
"7344",101026,"Umbriatico",999,352,374,726
"7345",17192,"Urago d'Oglio",999,1945,1828,3773
"7346",95069,"Uras",999,1314,1356,2670
"7347",28095,"Urbana",999,1010,1001,2011
"7348",41066,"Urbania",999,3376,3522,6898
"7349",9063,"Urbe",999,337,310,647
"7350",41067,"Urbino",999,6884,6955,13839
"7351",43055,"Urbisaglia",999,1193,1202,2395
"7352",16222,"Urgnano",999,5111,4958,10069
"7353",90076,"Uri",999,1463,1377,2840
"7354",70083,"Ururi",999,1153,1259,2412
"7355",91099,"Urzulei",999,536,539,1075
"7356",10064,"Uscio",999,1038,1105,2143
"7357",95070,"Usellus",999,347,345,692
"7358",90077,"Usini",999,2100,2079,4179
"7359",108044,"Usmate Velate",999,5282,5343,10625
"7360",111093,"Ussana",999,1987,2020,4007
"7361",111094,"Ussaramanna",999,243,234,477
"7362",91100,"Ussassai",999,230,217,447
"7363",1281,"Usseaux",999,88,86,174
"7364",1282,"Usseglio",999,102,89,191
"7365",43056,"Ussita",999,176,184,360
"7366",82075,"Ustica",999,670,640,1310
"7367",92090,"Uta",999,4515,4368,8883
"7368",47021,"Uzzano",999,2747,2895,5642
"7369",78152,"Vaccarizzo Albanese",999,484,510,994
"7370",57072,"Vacone",999,113,121,234
"7371",69098,"Vacri",999,742,753,1495
"7372",21105,"Vadena/Pfatten",999,590,511,1101
"7373",9064,"Vado Ligure",999,3882,4123,8005
"7374",48046,"Vaglia",999,2581,2650,5231
"7375",76094,"Vaglio Basilicata",999,892,942,1834
"7376",5111,"Vaglio Serra",999,131,128,259
"7377",46031,"Vagli Sotto",999,417,373,790
"7378",100006,"Vaiano",999,4792,5097,9889
"7379",19111,"Vaiano Cremasco",999,1762,1763,3525
"7380",1283,"Vaie",999,688,680,1368
"7381",19112,"Vailate",999,2321,2312,4633
"7382",61095,"Vairano Patenora",999,3030,3288,6318
"7383",93052,"Vajont",999,830,806,1636
"7384",16223,"Valbondione",999,476,477,953
"7385",16253,"Val Brembilla",999,2091,2031,4122
"7386",16224,"Valbrembo",999,2135,2217,4352
"7387",24125,"Valbrenta",999,2489,2373,4862
"7388",10065,"Valbrevenna",999,413,339,752
"7389",13229,"Valbrona",999,1308,1306,2614
"7390",1318,"Valchiusa",999,489,527,1016
"7391",24111,"Valdagno",999,12581,13184,25765
"7392",22232,"Valdaone",999,593,554,1147
"7393",21106,"Valdaora/Olang",999,1627,1580,3207
"7394",24112,"Valdastico",999,562,605,1167
"7395",1284,"Val della Torre",999,2027,1949,3976
"7396",96071,"Valdengo",999,1149,1204,2353
"7397",81022,"Valderice",999,5661,5728,11389
"7398",1317,"Val di Chy",999,642,592,1234
"7399",14071,"Valdidentro",999,2118,2061,4179
"7400",4233,"Valdieri",999,465,461,926
"7401",96088,"Valdilana",999,4886,5153,10039
"7402",83103,"Valdina",999,631,627,1258
"7403",18166,"Val di Nizza",999,285,278,563
"7404",14072,"Valdisotto",999,1805,1764,3569
"7405",21107,"Val di Vizze/Pfitsch",999,1564,1532,3096
"7406",25073,"Val di Zoldo",999,1373,1398,2771
"7407",26087,"Valdobbiadene",999,4849,5109,9958
"7408",2152,"Valduggia",999,908,930,1838
"7409",18167,"Valeggio",999,102,87,189
"7410",23089,"Valeggio sul Mincio",999,7921,8175,16096
"7411",56053,"Valentano",999,1379,1404,2783
"7412",6177,"Valenza",999,8627,9469,18096
"7413",72048,"Valenzano",999,8354,8867,17221
"7414",98059,"Valera Fratta",999,888,864,1752
"7415",54057,"Valfabbrica",999,1562,1664,3226
"7416",5112,"Valfenera",999,1230,1204,2434
"7417",22209,"Valfloriana",999,242,231,473
"7418",43058,"Valfornace",999,447,446,893
"7419",14073,"Valfurva",999,1216,1245,2461
"7420",12131,"Valganna",999,801,795,1596
"7421",1285,"Valgioie",999,531,426,957
"7422",16225,"Valgoglio",999,287,284,571
"7423",4234,"Valgrana",999,407,388,795
"7424",97082,"Valgreghentino",999,1706,1659,3365
"7425",7068,"Valgrisenche",999,109,79,188
"7426",86019,"Valguarnera Caropepe",999,3214,3623,6837
"7427",25062,"Vallada Agordina",999,214,242,456
"7428",96072,"Vallanzengo",999,96,103,199
"7429",22210,"Vallarsa",999,710,682,1392
"7430",64114,"Vallata",999,1213,1271,2484
"7431",61096,"Valle Agricola",999,362,392,754
"7432",21108,"Valle Aurina/Ahrntal",999,3054,2904,5958
"7433",8062,"Vallebona",999,612,595,1207
"7434",103079,"Valle Cannobina",999,239,213,452
"7435",67046,"Valle Castellana",999,451,392,843
"7436",60082,"Vallecorsa",999,1188,1213,2401
"7437",8063,"Vallecrosia",999,3210,3541,6751
"7438",65153,"Valle dell'Angelo",999,116,113,229
"7439",25063,"Valle di Cadore",999,901,953,1854
"7440",21109,"Valle di Casies/Gsies",999,1178,1135,2313
"7441",61097,"Valle di Maddaloni",999,1292,1338,2630
"7442",82076,"Valledolmo",999,1499,1616,3115
"7443",90079,"Valledoria",999,2165,2152,4317
"7444",79151,"Vallefiorita",999,672,778,1450
"7445",41068,"Vallefoglia",999,7688,7363,15051
"7446",22248,"Vallelaghi",999,2660,2596,5256
"7447",18168,"Valle Lomellina",999,1083,1032,2115
"7448",102045,"Vallelonga",999,421,350,771
"7449",85021,"Vallelunga Pratameno",999,1460,1597,3057
"7450",60083,"Vallemaio",999,434,460,894
"7451",58108,"Vallepietra",999,108,125,233
"7452",56054,"Vallerano",999,1173,1217,2390
"7453",111095,"Vallermosa",999,920,877,1797
"7454",60084,"Vallerotonda",999,699,687,1386
"7455",64115,"Vallesaccarda",999,601,629,1230
"7456",18169,"Valle Salimbene",999,728,732,1460
"7457",96074,"Valle San Nicolao",999,422,415,837
"7458",16226,"Valleve",999,69,55,124
"7459",24113,"Valli del Pasubio",999,1558,1508,3066
"7460",58109,"Vallinfreda",999,152,140,292
"7461",24123,"Val Liona",999,1552,1510,3062
"7462",17193,"Vallio Terme",999,686,724,1410
"7463",65154,"Vallo della Lucania",999,3770,4183,7953
"7464",54058,"Vallo di Nera",999,159,169,328
"7465",4235,"Valloriate",999,54,46,100
"7466",1286,"Vallo Torinese",999,394,386,780
"7467",6178,"Valmacca",999,474,504,978
"7468",97083,"Valmadrera",999,5568,5743,11311
"7469",14074,"Val Masino",999,439,391,830
"7470",58110,"Valmontone",999,7813,7942,15755
"7471",13232,"Valmorea",999,1296,1327,2623
"7472",34044,"Valmozzola",999,280,257,537
"7473",16227,"Valnegra",999,105,97,202
"7474",7069,"Valpelline",999,311,280,591
"7475",1287,"Valperga",999,1414,1546,2960
"7476",1288,"Valprato Soana",999,48,48,96
"7477",13233,"Val Rezzo",999,83,82,165
"7478",37061,"Valsamoggia",999,15920,16033,31953
"7479",7070,"Valsavarenche",999,79,74,153
"7480",77030,"Valsinni",999,639,679,1318
"7481",13234,"Valsolda",999,706,720,1426
"7482",103069,"Valstrona",999,579,576,1155
"7483",54059,"Valtopina",999,635,653,1288
"7484",16229,"Valtorta",999,127,109,236
"7485",7071,"Valtournenche",999,1150,1022,2172
"7486",65155,"Valva",999,775,761,1536
"7487",97093,"Valvarrone",999,249,240,489
"7488",93053,"Valvasone Arzene",999,1959,1990,3949
"7489",87052,"Valverde",999,3878,3961,7839
"7490",17194,"Valvestino",999,78,84,162
"7491",21110,"Vandoies/Vintl",999,1697,1660,3357
"7492",15249,"Vanzaghello",999,2623,2726,5349
"7493",15229,"Vanzago",999,4572,4800,9372
"7494",103070,"Vanzone con San Carlo",999,192,191,383
"7495",15230,"Vaprio d'Adda",999,4838,4744,9582
"7496",3153,"Vaprio d'Agogna",999,475,485,960
"7497",2156,"Varallo",999,3288,3568,6856
"7498",3154,"Varallo Pombia",999,2447,2533,4980
"7499",12132,"Varano Borghi",999,1202,1286,2488
"7500",34045,"Varano de' Melegari",999,1280,1289,2569
"7501",80095,"Varapodio",999,982,1032,2014
"7502",9065,"Varazze",999,6078,6461,12539
"7503",57073,"Varco Sabino",999,93,68,161
"7504",108045,"Varedo",999,6773,7130,13903
"7505",97084,"Varenna",999,335,346,681
"7506",12133,"Varese",999,37521,41298,78819
"7507",11029,"Varese Ligure",999,873,885,1758
"7508",1289,"Varisella",999,422,421,843
"7509",30130,"Varmo",999,1344,1301,2645
"7510",21111,"Varna/Vahrn",999,2560,2485,5045
"7511",34046,"Varsi",999,574,555,1129
"7512",18171,"Varzi",999,1497,1549,3046
"7513",103071,"Varzo",999,961,986,1947
"7514",56055,"Vasanello",999,1973,2013,3986
"7515",8064,"Vasia",999,184,177,361
"7516",69099,"Vasto",999,19963,20852,40815
"7517",94051,"Vastogirardi",999,304,292,596
"7518",1290,"Vauda Canavese",999,716,707,1423
"7519",102046,"Vazzano",999,453,496,949
"7520",26088,"Vazzola",999,3388,3363,6751
"7521",50037,"Vecchiano",999,5713,6094,11807
"7522",108046,"Vedano al Lambro",999,3573,3899,7472
"7523",12134,"Vedano Olona",999,3562,3851,7413
"7524",26089,"Vedelago",999,8317,8226,16543
"7525",16230,"Vedeseta",999,106,95,201
"7526",108047,"Veduggio con Colzano",999,2086,2086,4172
"7527",28096,"Veggiano",999,2415,2384,4799
"7528",75092,"Veglie",999,6383,6832,13215
"7529",96075,"Veglio",999,246,224,470
"7530",56056,"Vejano",999,1063,1075,2138
"7531",13236,"Veleso",999,101,101,202
"7532",18172,"Velezzo Lomellina",999,43,45,88
"7533",58111,"Velletri",999,25910,26988,52898
"7534",18173,"Vellezzo Bellini",999,1750,1723,3473
"7535",24115,"Velo d'Astico",999,1126,1128,2254
"7536",23090,"Velo Veronese",999,417,361,778
"7537",21116,"Velturno/Feldthurns",999,1557,1523,3080
"7538",94052,"Venafro",999,5295,5491,10786
"7539",1292,"Venaria Reale",999,15533,16627,32160
"7540",44073,"Venarotta",999,942,943,1885
"7541",4237,"Venasca",999,661,673,1334
"7542",1291,"Venaus",999,426,414,840
"7543",9066,"Vendone",999,174,167,341
"7544",12136,"Venegono Inferiore",999,2913,3068,5981
"7545",12137,"Venegono Superiore",999,3625,3721,7346
"7546",83104,"Venetico",999,1875,2094,3969
"7547",27042,"Venezia",999,120514,129855,250369
"7548",13238,"Veniano",999,1542,1593,3135
"7549",76095,"Venosa",999,5381,5401,10782
"7550",35046,"Ventasso",999,1950,1953,3903
"7551",64116,"Venticano",999,1129,1161,2290
"7552",8065,"Ventimiglia",999,11247,11680,22927
"7553",82077,"Ventimiglia di Sicilia",999,872,903,1775
"7554",59033,"Ventotene",999,384,308,692
"7555",30131,"Venzone",999,954,970,1924
"7556",108048,"Verano Brianza",999,4520,4647,9167
"7557",21112,"Verano/Vöran",999,524,472,996
"7558",103072,"Verbania",999,14290,15726,30016
"7559",78153,"Verbicaro",999,1292,1304,2596
"7560",13239,"Vercana",999,371,357,728
"7561",14075,"Verceia",999,529,551,1080
"7562",2158,"Vercelli",999,22092,23543,45635
"7563",97086,"Vercurago",999,1287,1407,2694
"7564",16232,"Verdellino",999,4001,3629,7630
"7565",16233,"Verdello",999,4160,4002,8162
"7566",97091,"Verderio",999,2751,2718,5469
"7567",4238,"Verduno",999,277,288,565
"7568",37059,"Vergato",999,3819,3833,7652
"7569",40050,"Verghereto",999,897,842,1739
"7570",12138,"Vergiate",999,4228,4387,8615
"7571",15251,"Vermezzo con Zelo",999,2915,2994,5909
"7572",22213,"Vermiglio",999,880,903,1783
"7573",4239,"Vernante",999,520,557,1077
"7574",33044,"Vernasca",999,1020,989,2009
"7575",15236,"Vernate",999,1736,1683,3419
"7576",11030,"Vernazza",999,346,362,708
"7577",100007,"Vernio",999,3091,3075,6166
"7578",75093,"Vernole",999,3177,3476,6653
"7579",17195,"Verolanuova",999,4031,4045,8076
"7580",17196,"Verolavecchia",999,1950,1862,3812
"7581",1293,"Verolengo",999,2342,2493,4835
"7582",60085,"Veroli",999,9635,9897,19532
"7583",23091,"Verona",999,122229,133414,255643
"7584",23092,"Veronella",999,2610,2521,5131
"7585",7072,"Verrayes",999,648,632,1280
"7586",7073,"Verrès",999,1234,1279,2513
"7587",18174,"Verretto",999,187,176,363
"7588",96076,"Verrone",999,579,593,1172
"7589",18175,"Verrua Po",999,576,597,1173
"7590",1294,"Verrua Savoia",999,681,648,1329
"7591",13242,"Vertemate con Minoprio",999,2047,2111,4158
"7592",16234,"Vertova",999,2130,2219,4349
"7593",99020,"Verucchio",999,5065,4987,10052
"7594",14076,"Vervio",999,104,97,201
"7595",30132,"Verzegnis",999,431,415,846
"7596",101027,"Verzino",999,756,808,1564
"7597",4240,"Verzuolo",999,3196,3224,6420
"7598",28097,"Vescovana",999,833,848,1681
"7599",19113,"Vescovato",999,1979,1959,3938
"7600",5113,"Vesime",999,314,278,592
"7601",3158,"Vespolate",999,1011,1028,2039
"7602",8066,"Vessalico",999,143,112,255
"7603",23093,"Vestenanova",999,1296,1203,2499
"7604",1295,"Vestignè",999,372,373,745
"7605",17197,"Vestone",999,2048,2069,4117
"7606",56057,"Vetralla",999,6585,6776,13361
"7607",35042,"Vetto",999,922,862,1784
"7608",4241,"Vezza d'Alba",999,1188,1163,2351
"7609",17198,"Vezza d'Oglio",999,736,751,1487
"7610",11031,"Vezzano Ligure",999,3486,3676,7162
"7611",35043,"Vezzano sul Crostolo",999,2154,2232,4386
"7612",9067,"Vezzi Portio",999,388,400,788
"7613",20066,"Viadana",999,10065,9879,19944
"7614",16235,"Viadanica",999,551,556,1107
"7615",87053,"Viagrande",999,4382,4553,8935
"7616",5114,"Viale",999,127,114,241
"7617",1296,"Vialfrè",999,130,128,258
"7618",35044,"Viano",999,1702,1716,3418
"7619",46033,"Viareggio",999,29107,31686,60793
"7620",5115,"Viarigi",999,416,422,838
"7621",65156,"Vibonati",999,1620,1591,3211
"7622",102047,"Vibo Valentia",999,15012,16020,31032
"7623",60086,"Vicalvi",999,341,381,722
"7624",82078,"Vicari",999,1151,1239,2390
"7625",48049,"Vicchio",999,4063,4038,8101
"7626",24116,"Vicenza",999,53300,57530,110830
"7627",71059,"Vico del Gargano",999,3576,3703,7279
"7628",63086,"Vico Equense",999,9907,10333,20240
"7629",4242,"Vicoforte",999,1553,1593,3146
"7630",68045,"Vicoli",999,188,193,381
"7631",3159,"Vicolungo",999,415,440,855
"7632",60087,"Vico nel Lazio",999,1027,1045,2072
"7633",50038,"Vicopisano",999,4160,4413,8573
"7634",58112,"Vicovaro",999,1754,1786,3540
"7635",90082,"Viddalba",999,797,796,1593
"7636",18176,"Vidigulfo",999,3381,3383,6764
"7637",26090,"Vidor",999,1798,1849,3647
"7638",1298,"Vidracco",999,224,242,466
"7639",71060,"Vieste",999,6595,6721,13316
"7640",76096,"Vietri di Potenza",999,1307,1337,2644
"7641",65157,"Vietri sul Mare",999,3515,3583,7098
"7642",97090,"Viganò",999,1033,1033,2066
"7643",16236,"Vigano San Martino",999,678,655,1333
"7644",38022,"Vigarano Mainarda",999,3794,3871,7665
"7645",23094,"Vigasio",999,5186,5122,10308
"7646",18177,"Vigevano",999,30425,32189,62614
"7647",76097,"Viggianello",999,1324,1324,2648
"7648",76098,"Viggiano",999,1624,1577,3201
"7649",12139,"Viggiù",999,2468,2719,5187
"7650",28098,"Vighizzolo d'Este",999,465,405,870
"7651",96077,"Vigliano Biellese",999,3607,3974,7581
"7652",5116,"Vigliano d'Asti",999,406,394,800
"7653",6179,"Vignale Monferrato",999,452,500,952
"7654",56058,"Vignanello",999,2136,2163,4299
"7655",15237,"Vignate",999,4570,4702,9272
"7656",36046,"Vignola",999,12706,13307,26013
"7657",22216,"Vignola-Falesina",999,112,87,199
"7658",6180,"Vignole Borbera",999,1012,1033,2045
"7659",4243,"Vignolo",999,1326,1359,2685
"7660",103074,"Vignone",999,583,601,1184
"7661",28099,"Vigodarzere",999,6483,6698,13181
"7662",25065,"Vigo di Cadore",999,650,688,1338
"7663",16237,"Vigolo",999,291,281,572
"7664",33045,"Vigolzone",999,2077,2088,4165
"7665",1299,"Vigone",999,2501,2524,5025
"7666",27043,"Vigonovo",999,4848,4996,9844
"7667",28100,"Vigonza",999,11427,11857,23284
"7668",6181,"Viguzzolo",999,1529,1541,3070
"7669",23095,"Villa Bartolomea",999,2939,2918,5857
"7670",46034,"Villa Basilica",999,723,739,1462
"7671",21113,"Villabassa/Niederdorf",999,825,805,1630
"7672",82079,"Villabate",999,9576,9974,19550
"7673",18178,"Villa Biscossi",999,31,32,63
"7674",17199,"Villa Carcina",999,5294,5411,10705
"7675",74020,"Villa Castelli",999,4493,4510,9003
"7676",68046,"Villa Celiera",999,259,284,543
"7677",17200,"Villachiara",999,701,665,1366
"7678",111096,"Villacidro",999,6513,6592,13105
"7679",46035,"Villa Collemandina",999,595,584,1179
"7680",15248,"Villa Cortese",999,3060,3162,6222
"7681",16238,"Villa d'Adda",999,2228,2366,4594
"7682",16239,"Villa d'Almè",999,3201,3278,6479
"7683",6182,"Villadeati",999,249,237,486
"7684",96078,"Villa del Bosco",999,144,164,308
"7685",28101,"Villa del Conte",999,2865,2759,5624
"7686",61098,"Villa di Briano",999,3719,3666,7385
"7687",14077,"Villa di Chiavenna",999,494,459,953
"7688",16240,"Villa di Serio",999,3285,3306,6591
"7689",14078,"Villa di Tirano",999,1490,1506,2996
"7690",16241,"Villa d'Ogna",999,872,906,1778
"7691",29048,"Villadose",999,2303,2354,4657
"7692",103075,"Villadossola",999,3004,3234,6238
"7693",28102,"Villa Estense",999,1050,1022,2072
"7694",4244,"Villafalletto",999,1430,1457,2887
"7695",8067,"Villa Faraldi",999,222,226,448
"7696",5117,"Villafranca d'Asti",999,1457,1489,2946
"7697",23096,"Villafranca di Verona",999,16225,16768,32993
"7698",45016,"Villafranca in Lunigiana",999,2349,2300,4649
"7699",28103,"Villafranca Padovana",999,5195,5377,10572
"7700",1300,"Villafranca Piemonte",999,2295,2309,4604
"7701",84043,"Villafranca Sicula",999,644,676,1320
"7702",83105,"Villafranca Tirrena",999,3710,4208,7918
"7703",82080,"Villafrati",999,1518,1586,3104
"7704",24117,"Villaga",999,939,935,1874
"7705",91101,"Villagrande Strisaili",999,1463,1459,2922
"7706",13245,"Villa Guardia",999,3850,4002,7852
"7707",22222,"Villa Lagarina",999,1948,1945,3893
"7708",66103,"Villalago",999,255,246,501
"7709",60088,"Villa Latina",999,574,567,1141
"7710",85022,"Villalba",999,675,715,1390
"7711",69100,"Villalfonsina",999,438,441,879
"7712",61099,"Villa Literno",999,6638,6062,12700
"7713",6183,"Villalvernia",999,435,421,856
"7714",69101,"Villamagna",999,1075,1078,2153
"7715",64117,"Villamaina",999,421,476,897
"7716",111097,"Villamar",999,1224,1197,2421
"7717",29049,"Villamarzana",999,573,558,1131
"7718",111098,"Villamassargia",999,1673,1661,3334
"7719",35045,"Villa Minozzo",999,1802,1707,3509
"7720",6184,"Villamiroglio",999,149,143,292
"7721",21114,"Villandro/Villanders",999,974,913,1887
"7722",96079,"Villanova Biellese",999,90,85,175
"7723",1301,"Villanova Canavese",999,585,623,1208
"7724",9068,"Villanova d'Albenga",999,1385,1394,2779
"7725",18179,"Villanova d'Ardenghi",999,375,379,754
"7726",5118,"Villanova d'Asti",999,2716,2768,5484
"7727",64118,"Villanova del Battista",999,709,755,1464
"7728",29050,"Villanova del Ghebbo",999,997,986,1983
"7729",98060,"Villanova del Sillaro",999,991,886,1877
"7730",28104,"Villanova di Camposampiero",999,3096,3092,6188
"7731",111100,"Villanovaforru",999,397,275,672
"7732",111101,"Villanovafranca",999,584,577,1161
"7733",29051,"Villanova Marchesana",999,469,432,901
"7734",4245,"Villanova Mondovì",999,2935,3041,5976
"7735",6185,"Villanova Monferrato",999,825,889,1714
"7736",90078,"Villanova Monteleone",999,1033,1043,2076
"7737",4246,"Villanova Solaro",999,383,354,737
"7738",33046,"Villanova sull'Arda",999,832,821,1653
"7739",95071,"Villanova Truschedu",999,138,159,297
"7740",111099,"Villanova Tulo",999,524,480,1004
"7741",18180,"Villanterio",999,1716,1662,3378
"7742",17201,"Villanuova sul Clisi",999,2870,3000,5870
"7743",111102,"Villaperuccio",999,487,511,998
"7744",78154,"Villapiana",999,2695,2784,5479
"7745",111103,"Villaputzu",999,2194,2243,4437
"7746",1302,"Villarbasse",999,1744,1815,3559
"7747",2163,"Villarboit",999,187,185,372
"7748",1303,"Villar Dora",999,1386,1423,2809
"7749",1304,"Villareggia",999,491,505,996
"7750",1305,"Villar Focchiardo",999,938,990,1928
"7751",63087,"Villaricca",999,15249,16202,31451
"7752",6186,"Villaromagnano",999,323,331,654
"7753",86020,"Villarosa",999,2052,2276,4328
"7754",1306,"Villar Pellice",999,527,530,1057
"7755",1307,"Villar Perosa",999,1904,1955,3859
"7756",4247,"Villar San Costanzo",999,814,761,1575
"7757",111104,"Villasalto",999,472,465,937
"7758",80096,"Villa San Giovanni",999,6218,6502,12720
"7759",56046,"Villa San Giovanni in Tuscia",999,618,613,1231
"7760",92099,"Villa San Pietro",999,1097,1065,2162
"7761",5119,"Villa San Secondo",999,190,199,389
"7762",108049,"Villasanta",999,6880,7383,14263
"7763",60089,"Villa Santa Lucia",999,1245,1232,2477
"7764",66104,"Villa Santa Lucia degli Abruzzi",999,47,40,87
"7765",69102,"Villa Santa Maria",999,557,553,1110
"7766",66105,"Villa Sant'Angelo",999,225,265,490
"7767",95048,"Villa Sant'Antonio",999,166,162,328
"7768",30133,"Villa Santina",999,995,1132,2127
"7769",60090,"Villa Santo Stefano",999,789,806,1595
"7770",111105,"Villasimius",999,1881,1839,3720
"7771",111106,"Villasor",999,3308,3284,6592
"7772",111107,"Villaspeciosa",999,1316,1302,2618
"7773",1308,"Villastellone",999,2136,2238,4374
"7774",2164,"Villata",999,766,746,1512
"7775",95072,"Villaurbana",999,721,725,1446
"7776",66106,"Villavallelonga",999,398,427,825
"7777",95073,"Villa Verde",999,129,139,268
"7778",24118,"Villaverla",999,3046,2918,5964
"7779",22249,"Ville d'Anaunia",999,2349,2323,4672
"7780",22254,"Ville di Fiemme",999,1324,1326,2650
"7781",7074,"Villeneuve",999,706,579,1285
"7782",31025,"Villesse",999,793,812,1605
"7783",66107,"Villetta Barrea",999,313,295,608
"7784",103076,"Villette",999,135,142,277
"7785",20068,"Villimpenta",999,1063,1069,2132
"7786",16242,"Villongo",999,4156,3994,8150
"7787",26091,"Villorba",999,8574,9036,17610
"7788",16243,"Vilminore di Scalve",999,714,718,1432
"7789",108050,"Vimercate",999,12626,13371,25997
"7790",15242,"Vimodrone",999,8130,8690,16820
"7791",4248,"Vinadio",999,295,280,575
"7792",70084,"Vinchiaturo",999,1680,1699,3379
"7793",5120,"Vinchio",999,280,259,539
"7794",48050,"Vinci",999,7136,7448,14584
"7795",1309,"Vinovo",999,7508,7848,15356
"7796",3164,"Vinzaglio",999,281,245,526
"7797",4249,"Viola",999,200,179,379
"7798",17202,"Vione",999,305,324,629
"7799",21115,"Vipiteno/Sterzing",999,3452,3503,6955
"7800",1310,"Virle Piemonte",999,581,571,1152
"7801",17203,"Visano",999,1000,979,1979
"7802",1311,"Vische",999,585,599,1184
"7803",63088,"Visciano",999,2025,2111,4136
"7804",30135,"Visco",999,398,432,830
"7805",6187,"Visone",999,598,582,1180
"7806",43057,"Visso",999,458,494,952
"7807",18181,"Vistarino",999,810,768,1578
"7808",1312,"Vistrorio",999,255,275,530
"7809",81023,"Vita",999,866,895,1761
"7810",56059,"Viterbo",999,32267,33974,66241
"7811",60091,"Viticuso",999,143,153,296
"7812",93049,"Vito d'Asio",999,359,362,721
"7813",56060,"Vitorchiano",999,2607,2648,5255
"7814",88012,"Vittoria",999,33167,31511,64678
"7815",26092,"Vittorio Veneto",999,13128,14089,27217
"7816",66108,"Vittorito",999,382,437,819
"7817",15243,"Vittuone",999,4590,4658,9248
"7818",62077,"Vitulano",999,1411,1302,2713
"7819",61100,"Vitulazio",999,3734,3957,7691
"7820",1313,"Viù",999,561,556,1117
"7821",93050,"Vivaro",999,695,636,1331
"7822",58113,"Vivaro Romano",999,85,68,153
"7823",96080,"Viverone",999,657,683,1340
"7824",87054,"Vizzini",999,2717,2932,5649
"7825",12140,"Vizzola Ticino",999,311,277,588
"7826",15244,"Vizzolo Predabissi",999,1910,1958,3868
"7827",28105,"Vo'",999,1632,1618,3250
"7828",17204,"Vobarno",999,4242,4067,8309
"7829",10066,"Vobbia",999,207,171,378
"7830",2166,"Vocca",999,85,73,158
"7831",25066,"Vodo Cadore",999,401,421,822
"7832",18182,"Voghera",999,18967,20144,39111
"7833",38023,"Voghiera",999,1757,1829,3586
"7834",103077,"Vogogna",999,849,835,1684
"7835",22224,"Volano",999,1555,1566,3121
"7836",63089,"Volla",999,12648,13016,25664
"7837",19114,"Volongo",999,239,216,455
"7838",26093,"Volpago del Montello",999,4946,5104,10050
"7839",18183,"Volpara",999,70,52,122
"7840",6188,"Volpedo",999,561,573,1134
"7841",6189,"Volpeglino",999,66,60,126
"7842",1314,"Volpiano",999,7461,7685,15146
"7843",6190,"Voltaggio",999,316,335,651
"7844",25067,"Voltago Agordino",999,380,426,806
"7845",20070,"Volta Mantovana",999,3545,3683,7228
"7846",50039,"Volterra",999,4583,4901,9484
"7847",19115,"Voltido",999,169,162,331
"7848",71061,"Volturara Appula",999,170,200,370
"7849",64119,"Volturara Irpina",999,1408,1504,2912
"7850",71062,"Volturino",999,725,800,1525
"7851",1315,"Volvera",999,4170,4266,8436
"7852",4250,"Vottignasco",999,249,245,494
"7853",102048,"Zaccanopoli",999,317,328,645
"7854",87055,"Zafferana Etnea",999,4724,4673,9397
"7855",79157,"Zagarise",999,679,713,1392
"7856",58114,"Zagarolo",999,9422,9208,18630
"7857",102049,"Zambrone",999,857,914,1771
"7858",16244,"Zandobbio",999,1371,1325,2696
"7859",24119,"Zanè",999,3211,3347,6558
"7860",16245,"Zanica",999,4345,4329,8674
"7861",71064,"Zapponeta",999,1707,1586,3293
"7862",18184,"Zavattarello",999,431,453,884
"7863",18185,"Zeccone",999,829,858,1687
"7864",95074,"Zeddiani",999,555,569,1124
"7865",13246,"Zelbio",999,102,82,184
"7866",98061,"Zelo Buon Persico",999,3655,3774,7429
"7867",18186,"Zeme",999,520,462,982
"7868",18187,"Zenevredo",999,242,249,491
"7869",26094,"Zenson di Piave",999,843,899,1742
"7870",33047,"Zerba",999,40,32,72
"7871",18188,"Zerbo",999,187,199,386
"7872",18189,"Zerbolò",999,841,806,1647
"7873",95075,"Zerfaliu",999,475,509,984
"7874",45017,"Zeri",999,449,473,922
"7875",24120,"Zermeghedo",999,688,647,1335
"7876",26095,"Zero Branco",999,5808,5835,11643
"7877",23097,"Zevio",999,7845,7831,15676
"7878",22226,"Ziano di Fiemme",999,866,914,1780
"7879",33048,"Ziano Piacentino",999,1281,1195,2476
"7880",15247,"Zibido San Giacomo",999,3368,3355,6723
"7881",11032,"Zignago",999,238,231,469
"7882",23098,"Zimella",999,2493,2373,4866
"7883",96081,"Zimone",999,194,183,377
"7884",18190,"Zinasco",999,1521,1576,3097
"7885",10067,"Zoagli",999,1181,1198,2379
"7886",36047,"Zocca",999,2385,2305,4690
"7887",16246,"Zogno",999,4226,4342,8568
"7888",37060,"Zola Predosa",999,9465,9912,19377
"7889",75094,"Zollino",999,872,966,1838
"7890",17205,"Zone",999,522,505,1027
"7891",25069,"Zoppè di Cadore",999,96,94,190
"7892",93051,"Zoppola",999,4197,4178,8375
"7893",24121,"Zovencedo",999,436,387,823
"7894",96082,"Zubiena",999,579,557,1136
"7895",9069,"Zuccarello",999,134,150,284
"7896",24122,"Zugliano",999,3370,3539,6909
"7897",30136,"Zuglio",999,271,264,535
"7898",96083,"Zumaglia",999,463,498,961
"7899",78155,"Zumpano",999,1282,1323,2605
"7900",64120,"Zungoli",999,447,489,936
"7901",102050,"Zungri",999,939,902,1841
